Aaron	KY
Greenwich	UT
Lockbridge	WV
Winona	TN
Excelsior	PA
Boggs	WV
Derry	LA
Averill	VT
Crayne	KY
Cottle	KY
Pohnpei	FM
Gardenville	PA
Saldee	KY
Lenox	KY
Green Park	PA
Baughman	KY
Shook	MO
Sias	WV
Riceville	PA
Ophir	KY
Paw Paw	KY
McKinley	MN
Redondo	WA
Smartville	CA
Bays	KY
San Luis Rey	CA
Kilsyth	WV
New Town	MA
Moreland	ID
East Stone Gap	VA
Fairview	WY
Atlantic	ME
Okreek	SD
Jerome	MO
Long Branch	WV
Coopersville	KY
Frenchton	WV
Trotters	ND
Elbridge	TN
Davis Wharf	VA
Twist	AR
Goldsboro	TX
Magnolia Springs	TX
Solsville	NY
Waldron	KS
Vertrees	KY
Whallonsburg	NY
Judson	IN
Mcclellan Afb	CA
Bowring	OK
Rose Lodge	OR
Andersonville	VA
Sprague	WV
Moko	AR
Chriesman	TX
Bakers Summit	PA
Tribbett	MS
Saginaw	OR
Red Ash	VA
North Ferrisburg	VT
Lockney	WV
Nuttsville	VA
Bigbee Valley	MS
New Lebanon	IN
Rome	IA
State Park	SC
Cobhill	KY
Aneth	UT
Landess	IN
Quicksand	KY
West Prestonsburg	KY
Grays Knob	KY
Leander	KY
Sebastians Branch	KY
Windy	KY
Marshallville	KY
Yap	FM
Fowlkes	TN
Coalmont	CO
Pitt	MN
Mikkalo	OR
Neafus	KY
Lincoln Acres	CA
Oraville	IL
West Buxton	ME
Bruin	KY
Denver	KY
Elmira	WV
Sawyer	KY
Seitz	KY
Curllsville	PA
Thompson	UT
Page	WV
Craig	IA
Blakes	VA
North Clymer	NY
Everettville	WV
Seaview	VA
Ridgeway	MI
Saint Marie	MT
Fairport	MO
Elmendorf Afb	AK
Thornton	MS
Chalk	TX
Otisco	MN
Mount Sunapee	NH
Moyers	WV
Crichton	WV
Board Camp	AR
Hazelgreen	WV
West Greene	AL
Paauhau	HI
Colmar	IL
Maryus	VA
Saxeville	WI
Sheldon Point	AK
Alma	AL
Hagar Shores	MI
Barbers Point N A S	HI
Chaffee	ND
Cataract	WI
Mesena	GA
Ozone	TN
Hoyt	OK
Brookline Station	MO
Milwaukee	NC
Mid Hudson	NY
Minot	MA
Teigen	MT
Yukon	WV
Connellys Springs	NC
Blue Gap	AZ
Davant	LA
Nikep	MD
Fullerton	LA
Capels	WV
Fedhaven	FL
Juneau	PA
English	WV
Iron Springs	AZ
Wick	WV
Model	CO
Holy City	CA
Glover	MO
Peytonsburg	KY
South Waterford	ME
Inman	GA
Keslers Cross Lanes	WV
Hendricks	KY
Ely	VT
Clayton Lake	ME
Crystal	KY
Glenwood	FL
Canadys	SC
Sebago Lake	ME
Ladys Island	SC
Arden	NY
Cherry Creek	SD
Henryton	MD
Brinkley	KY
Small Point	ME
City	County
Melder	LA
Macon	VA
Rago	KS
Silver Beach	MA
Beechwood	MI
Halfway	KY
Supply	VA
Marshall Islands	MH
Delphos	IA
Doctors Inlet	FL
Confluence	KY
Homer	MN
Trebloc	MS
Chuuk	FM
Overly	ND
Highlandville	IA
Cayuse	OR
Sonnette	MT
Soldier Pond	ME
Carbondale	OH
Vliets	KS
Granger	MN
Carlisle	LA
Rock Castle	WV
Salona	PA
Waka	TX
Redford	TX
Pellville	KY
Bentree	WV
Thacker	WV
Macon	TN
Bergoo	WV
Palmyra	NC
Modeste	LA
Falls Mill	WV
Hatton	AR
Ark	VA
Brunswick	MI
Gulnare	CO
Strange Creek	WV
Aldenville	PA
Milford	MO
Advent	WV
Kelly Lake	MN
Peoples	KY
Perote	AL
Saint Joseph	WI
Andover	VA
South Hiram	ME
Hunter	KY
Coalfield	TN
Tripler Army Medical Ctr	HI
Nicut	WV
Havaco	WV
Mission Ridge	SD
Raynham Center	MA
Opheim	IL
Lew Beach	NY
Money	MS
Palermo	WV
Palau	PW
Primrose	KY
Brownton	WV
Hickory Withe	TN
Mid Island	NY
Big Run	WV
Kurthwood	LA
Brooks	WI
Avalon	MS
Saint Andrews	TN
Geneva	TX
Mountain	WV
Zachariah	KY
Modest Town	VA
Oscar	OK
Toivola	MN
King And Queen Court Hous	VA
Greenwich	KS
Harriston	MS
Dogue	VA
West Willow	PA
Lake Hubert	MN
Waiteville	WV
McCombs	KY
Dabolt	KY
Old Landing	KY
Vista	MO
Paradise Inn	WA
Clintonville	WV
Glad Valley	SD
Ricetown	KY
Hadley	KY
Mira	LA
Peacock	TX
Mountain Home	UT
Sanatorium	MS
Woronoco	MA
Bartlett	IA
Dizney	KY
Stet	MO
Bakerton	KY
Frankfort Heights	IL
Lisbon Center	ME
Exchange	WV
Gillmore	KY
Royalty	TX
Cokercreek	TN
Margie	MN
New Almelo	KS
Strongs	MI
Manset	ME
Horse Creek	WY
Balm	FL
Bill	WY
Cowanesque	PA
Tinian	MP
Dickinson	PA
Cranberry	WV
Bell Ranch	NM
Emerson	KY
Century	WV
Birdeye	AR
Whitehouse	KY
Bustins Island	ME
Caplinger Mills	MO
East Freetown	NY
Pryor	CO
Cologne	VA
Jacobs	KY
Gusher	UT
Ammon	VA
Jonben	WV
Mobjack	VA
Plain View	VA
Isle Of Springs	ME
Prairie	AL
Stockdale	OH
Radcliff	OH
Leblanc	LA
K I Sawyer A F B	MI
Villamont	VA
Wilsonburg	WV
Brohard	WV
Denver	TN
Milan	WI
Elsmere	NE
Glasgo	CT
Grimms Landing	WV
Tolu	KY
Meadow Creek	WV
Harmon	LA
Chelsea	WI
North Shapleigh	ME
Lamison	AL
FPO	AA
Blanchard	ND
Brill	WI
Caney	KY
Handsom	VA
Prattville	MI
Lindseyville	KY
Hollybush	KY
Dreyfus	KY
Hightown	VA
Sawmill	AZ
Bethlehem	SD
Helfenstein	PA
London	MN
Wakenda	MO
Horton	MO
Otto	TX
Lundale	WV
Buskirk	KY
Sunnyside	FL
East Point	LA
Gheen	MN
Rollins Fork	VA
Linden	WV
Barrett	WV
Lodi	TX
Bavon	VA
Wolfe	WV
Isaban	WV
Wardtown	VA
Bremen	ND
Maynard	OH
Ramsey	WV
Kanawha Falls	WV
Bridgeland	UT
Putnam Hall	FL
Manassas	GA
Pocahontas	MS
Harrison	WV
Tetlin	AK
Firebrick	KY
Cobham	VA
Tefft	IN
Cotton	GA
Pilottown	LA
Arlington Heights	MA
Gladeville	TN
Kettle	KY
Kenilworth	UT
Gardena	ND
East Candia	NH
Unity	IL
Slick Rock	CO
Experiment	GA
Hiawatha	UT
Cauthornville	VA
Blount	WV
Melrose	CT
Decoy	KY
Winston	KY
Brittany	LA
Stouts Mills	WV
March Air Force Base	CA
Cromwell	AL
Summertown	GA
Jamboree	KY
Carver	KY
South Britain	CT
Crown Hill	WV
Wolf Summit	WV
Floyd Dale	SC
Kaibito	AZ
New York City	NY
Job	KY
Ameagle	WV
Takotna	AK
Horse Shoe Run	WV
Greens Farms	CT
Lone	KY
Nevisdale	KY
Ojo Feliz	NM
Segundo	CO
Mount Dora	NM
Hill City	ID
Norristown	GA
Canebrake	WV
Klossner	MN
Zim	MN
Leroy	PA
Blackford	KY
Kona	KY
Pine Bank	PA
Lamero	KY
Whon	TX
Village	AR
Lee City	KY
McKittrick	MO
Chester Depot	VT
Lawrenceville	NY
Grayling	AK
Lyoth	CA
Burkes Garden	VA
Minturn	SC
Goose Prairie	WA
University Of Richmond	VA
Parrot	KY
Bryceland	LA
Dryden	TX
Limerick	NY
Birome	TX
Edwardsville	VA
Herald	IL
Sycamore Valley	OH
Bluehole	KY
Cundiff	KY
Ravine	PA
Kosrae	FM
Sharon	WV
Summit	KY
East Waterford	ME
Wilsie	WV
Ben Arnold	TX
Pejepscot	ME
Voth	TX
Vick	LA
Togo	MN
Columbus	IL
Frankclay	MO
Stephensburg	KY
Stalwart	MI
Rockland M P C	NY
Ingold	NC
Eudora	MO
Reese Air Force Base	TX
Talbot	IN
Meers	OK
Pear Valley	TX
Joinerville	TX
Eckelson	ND
Herrick Center	PA
Clio	WV
Alden	IL
Huff	KY
Emmett	WV
Holy Trinity	AL
Bethera	SC
Oakville	KY
Light Street	PA
Idlewild	TN
Lake Cicott	IN
Little River	TX
Dumont	TX
Mills	KY
Mc Clurg	MO
West Mystic	CT
Tariff	WV
Allegre	KY
Dawmont	WV
Toyahvale	TX
Sundial	WV
Kent	AL
Allenton	MO
Gapville	KY
West Millbury	MA
Torch	OH
Baker Hill	AL
Uncle Sam	LA
Amburgey	KY
Volney	VA
Letter Gap	WV
DEDEDO	GU
Freeman	WA
Willard	MT
Day	FL
North Westchester	CT
Hochheim	TX
Price	MD
Dodgertown	CA
Swan Lake	MS
Grissom Afb	IN
Mistletoe	KY
Garneill	MT
Winterville	ME
Stinson Lake	NH
Athol	KY
Cobalt	ID
Urbana	AR
Flora	LA
Haynesville	ME
Passaic	MO
Turnerville	GA
East Greenwich	NY
Sandford	IN
Kivalina	AK
Glendon	WV
Red Valley	AZ
Whipholt	MN
San Acacio	CO
Blandville	WV
Wewela	SD
Marydell	KY
Ohley	WV
Merna	IL
Bridgewater	MI
Ebeye	MH
Conasauga	TN
Pennsville	OH
Avalon	MO
Willow Shade	KY
Talcum	KY
Pope A F B	NC
Miston	TN
Elco	IL
Steff	KY
Lavaca	AL
Upper Hill	MD
Stidham	OK
Frostburg	PA
North Western	NY
Shortt Gap	VA
Leckie	WV
Robertsburg	WV
Fife	VA
Lawen	OR
Irwinville	GA
Squirrel Island	ME
Cache	IL
Barber	NC
Speaks	TX
Cisco	KY
Southern Md Facility	MD
Craynor	KY
Triplett	NC
Fostoria	KS
Kyle	WV
North Washington	IA
Grove	ME
Halo	KY
Fairacres	NM
Estill	KY
Shirley Basin	WY
Sennett	NY
Snow Hill	AL
Michael	IL
Cholame	CA
Greenway	VA
Chatfield	AR
Steffenville	MO
Swift	MN
Lecoma	MO
Ah Gwah Ching	MN
Verda	LA
Maple City	KS
Saul	KY
Superior	WV
Wolford	VA
Conran	MO
Camp Dix	KY
Santa Rita	MT
Norway	OR
Powellville	MD
Oak Grove	MI
Etterville	MO
Grass Creek	IN
Vandalia	MT
Flicksville	PA
Orrin	ND
North Lakewood	WA
Kelsey	MN
Latour	MO
New Offenburg	MO
Sailor Springs	IL
Meriden	MN
Copen	WV
Baker	MN
Climax	PA
Lambric	KY
FPO	AP
Medley	WV
Galloway	WV
Miccosukee Cpo	FL
Round Pond	AR
Northland	MI
Salitpa	AL
Galveston	KY
Labarre	LA
Powhatan	WV
Mccain	NC
West Grove	IA
Harold	FL
Lincoln Center	ME
Saint Helens	KY
Larto	LA
La Grange	AR
Sloans Valley	KY
Darwin	CA
Mexican Springs	NM
Quality	KY
Alpoca	WV
Altro	KY
Se Ree	KY
Detroit	IL
Arena	ND
Hamilton Dome	WY
Plainfield	GA
Lima	WV
Cinda	KY
Chestnut Mountain	GA
Conda	ID
Chewalla	TN
Stumptown	WV
Bryant	FL
Magnolia	MD
James Store	VA
Guerra	TX
Texhoma	TX
Garrison	MD
Nelse	KY
Cutten	CA
Laneburg	AR
Siluria	AL
Beaverlett	VA
Brady Lake	OH
Naxera	VA
Skygusty	WV
Tallega	KY
Narrows	KY
Sprott	AL
Lee Mont	VA
Samnorwood	TX
Beards Fork	WV
Stewartsville	OH
Industry	NY
Endicott	KY
Holly Ridge	MS
Tunnel City	WI
Mohler	WA
Unity House	PA
Little York	NJ
Pernell	OK
Short Creek	OH
Node	WY
Provo	KY
Boyero	CO
Brooke	VA
Lambert Lake	ME
Saum	MN
Perry	TX
Samuels	ID
Mentor	KS
Frye	ME
Radersburg	MT
Birds	IL
Menfro	MO
Flat	AK
Crest Park	CA
Iona	SD
Concord	KY
Homelake	CO
Blue Hill Falls	ME
Hebert	LA
Penrod	KY
Bigbee	AL
Lincoln'S New Salem	IL
Jigger	LA
Bristol	CO
Howell	AR
Brandeis	CA
Kempster	WI
Mahto	SD
True	WV
Hickam Afb	HI
Keith	KY
Poe	WV
Bloom City	WI
La Loma	NM
White Oak	KY
Oldhams	VA
Dardanelle	CA
Bucks Harbor	ME
Wabaningo	MI
Mariba	KY
Lingo	NM
Wittenberg	MO
South Fork	MO
Belen	MS
Huntsville	KY
Haldeman	KY
Elsie	KY
Longisland	NC
Adrian	IL
Fruitvale	TN
Milltown	KY
Seneca	NM
Brookview	NY
Red Creek	WV
Braden	TN
Williamson	PA
Borden	SC
Cross Anchor	SC
Stephens	KY
Kearsarge	MI
Balmat	NY
Quay	NM
Mildred	MT
Annemanie	AL
Twin Branch	WV
Sheds	NY
Knapp Creek	NY
Hamlet	NE
Morvin	AL
Good Hart	MI
Rockybranch	KY
Weirwood	VA
White Plains	NC
Capeville	VA
Mc Condy	MS
New Rumley	OH
Treloar	MO
Oven Fork	KY
South Effingham	NH
Branch	WI
North Spring	WV
Maher	CO
Fairforest	SC
Beulah Heights	KY
Niarada	MT
Pleasant Grove	MS
Pomeroyton	KY
New Hartford	MO
Thurston	OR
Cardville	ME
Bohannon	VA
Beaumont	VA
Migrate	KY
Hall Park	OK
Nonantum	MA
Red Wing	CO
Blandville	KY
Vanderbilt Beach	FL
Swamp Branch	KY
Mc Cabe	MT
Squirrel	ID
Bush	KY
Alpha	IA
Sibley	MS
Marshall	ND
Berea	WV
Bass	AR
Spring Lick	KY
Sherman Mills	ME
Raisin	CA
Montcoal	WV
Valley Chapel	WV
Warner	VA
Greenbush	MA
Bradshaw	MD
Valois	NY
Amsden	OH
Big Spring	KY
Galloway	WI
Burnwell	AL
Ottine	TX
Cranberry	NC
Almelund	MN
Talbert	KY
La Madera	NM
Munday	WV
Cone	TX
Emma	IL
Killarney	FL
Solon Mills	IL
Cedarvale	NM
Tula	MS
Corral	ID
Buena	WA
Cardiff	AL
National Mine	MI
Eriline	KY
Shawanee	TN
Vulcan	WV
Grantsdale	MT
Millbrook	MI
South Willington	CT
Brinsmade	ND
Hyner	PA
Eckman	WV
APO	AP
Mount Vernon	TN
Glace	WV
Turner Center	ME
Saint Mary	NE
Bodines	PA
Harman	VA
Louvale	GA
Mustoe	VA
Amf Ohare	IL
Teresita	MO
Maybeury	WV
Halleck	NV
Riderwood	MD
Charlton Depot	MA
Rockfield	WI
Glencross	SD
Light	AR
Clearview	OK
Climax	CO
Como	TN
Boyds	WA
Palo	MI
Theilman	MN
Murraysville	WV
Ivyton	KY
Harlem Springs	OH
Bakewell	TN
Smyrna	MI
Cima	CA
Sharon	MS
Sebec Lake	ME
West Copake	NY
Maysfield	TX
Insko	KY
Crown	KY
Estcourt Station	ME
Judson	TX
Lille	ME
Sardinia	SC
Swedeborg	MO
Pruden	TN
Redstar	WV
Merepoint	ME
Allen	AL
Andrews A F B	DC
Hamberg	ND
Sarton	WV
Lloyd	KY
Skene	MS
Capitol	MT
Elton	WV
Island City	KY
Garrison	MO
Walker Springs	AL
East Homer	NY
Luke Afb	AZ
Lone Mountain	TN
Magnet	IN
Bozoo	WV
Harlan	KS
Painton	MO
Cook Station	MO
Hamletsburg	IL
Lorentz	WV
Winona	WV
Rossmore	WV
Conway	KY
Marion	OR
Bretz	WV
Fox Valley	IL
Costigan	ME
Mc Neil	TX
Overstreet	FL
Artesia Wells	TX
Gilmer	WV
Kline	SC
Moon	KY
Rich	MS
Tobinsport	IN
Edna	KY
Ft Devens	MA
Eagan	TN
Winterville	MS
Wendell Depot	MA
Lola	KY
Sproul	PA
Wyco	WV
Leeco	KY
Noctor	KY
Hannibal	WI
Whitmer	WV
Colton	OH
Goodway	AL
Porters Falls	WV
Branchton	PA
Lynxville	WI
Menges Mills	PA
Tomato	AR
Saint Bethlehem	TN
Loveland	OK
Blakely	AR
Green Hall	KY
Shinhopple	NY
Cunningham	WA
Rossburg	NY
Pool	WV
Heidelberg	KY
Meyers Chuck	AK
Cedar City	MO
Axtell	UT
Waterview	KY
Newtown	WV
Carey	TX
Wheeler	AR
Cascade	MO
Delft	MN
Glenhayes	WV
Durants Neck	NC
Kanaranzi	MN
Lacey Spring	VA
Meadows	NH
Webster Crossing	NY
Llano	NM
East Mansfield	MA
West Peterborough	NH
Milton Village	MA
Lacamp	LA
Gough	GA
Collins	AR
Waveland	AR
Leon Junction	TX
Arcola	PA
Grassy Meadows	WV
Jamesville	VA
Riverside	OR
Hale	IA
Mc Veigh	KY
Chicago Bmc	IL
Fly	OH
Taplin	WV
Fuget	KY
Fortescue	MO
Lawyersville	NY
Rollingbay	WA
Bula	TX
Daisy	KY
Kalvesta	KS
Mattson	MS
Treadway	TN
Cadiz	CA
Lamona	WA
APO	AA
Offutt	KY
Nitta Yuma	MS
Bible School Park	NY
Hampden	WV
Allred	TN
East Parsonfield	ME
Eaton	TN
Petrey	AL
Northpoint	PA
Delta City	MS
Bellamy	VA
Brooklyn	KY
Winchester	NV
Gumberry	NC
Quimby	ME
Keeline	WY
Kieffer	WV
Quecreek	PA
Colburn	ID
Dabneys	VA
Starkville	CO
Millers Ferry	AL
Pryse	KY
Wakulla	NC
Sunfish	KY
Simpson	WV
Republican Grove	VA
Balch	AR
Booth	WV
Shattuckville	MA
Crumpler	WV
Ingle	KY
Kincaid	WV
Bowen	KY
Pleasant Valley	VA
Jenkins Bridge	VA
Deep Water	WV
Cat Creek	MT
Kistler	WV
Belmont	WA
Hemphill	WV
Couch	MO
Old Mission	MI
Manasota	FL
Leatherwood	KY
Carlisle	MS
Trammel	VA
Saint Paul	KY
Tanner	WV
Quinnimont	WV
Lerose	KY
Worth	WV
Clay	TX
Kirkland	TX
Lowder	IL
Lenox	TN
Zacata	VA
Ames	KS
Paul	AL
Coosawatchie	SC
Falcon	MS
Oyster	VA
Cumnock	NC
Mount Moriah	MO
Dames Quarter	MD
Fox	OR
Butters	NC
Ecleto	TX
East Hebron	NH
Pandora	TX
Reform	MS
Keene	OH
Emison	IN
Huntington Lake	CA
Bexar	AR
Pratts Hollow	NY
Sugarloaf Shores	FL
Dothan	WV
Mayfield	OK
Fanrock	WV
Fabyan	CT
North Brooklin	ME
Glenview Nas	IL
Perkins	WV
Mid Missouri	MO
Long Mott	TX
Oakdale	MA
Natrona	WY
Burrel	CA
Big Rock	IA
Brucetown	VA
Delta	KY
Garcia	CO
