Southaven	CA
Evansville	PA
Cottonwood Shores	TX
Indian River Shores	FL
Snyder	NY
Coral Gables	FL
West Bridgewater	PA
Champoeg	OR
Laurinburg	SC
Tompkins	MI
Kiawah Island	SC
Lackawanna	NY
Samples Manor	MD
Lawrence	MO
Brunswick	RI
Vancouver	AZ
Rochester Hls	MI
Elizabethport	NJ
Washington	SC
Fort Gaines	AL
Sleepy Hollow	NY
Walkerville	MT
Independence	TX
Galloway	NJ
Manson	MN
Lutz	CT
Mount Comfort	IN
Kansas City	MN
United States Air Force Acad	CO
Jerome	TX
Denver	MI
Watch Hill	RI
Skyline	MN
Edisto	SC
Davis	MI
Mozart	WV
Leetown	WV
Raccoon	PA
Montville	ME
Otto	MO
Delavan	KS
La Canada	CA
Rockingham	MD
Auburn	MO
Sheridan	NE
Marlborough	PA
Yale	WA
Portland	MD
Otsego Lake	MI
Bear Creek	AK
Windthorst	KS
Annette	AK
Henderson	LA
Michaux	VA
Baring Plt	ME
Loma Rica	CA
Phillips	TX
Broken Arrow	MD
Olive Branch	KY
Upper Arlington	OH
Oswego	NM
North Cohocton	NY
Clitherall	MO
Fonde	KY
Trooper	PA
New London Township	PA
Bear Grove	IL
Petersburgh	NY
West Franklin	NH
Eugene	IN
Glenn Heights	TX
Cox	GA
Bayside	WI
Geddes	NE
Foxfield	CO
Braceville	OH
Maxton	SC
Princeton	AR
Westwood Hills	KS
Woodinville	NE
East Side	TX
White Lake	UT
Mt Gretna	PA
Parks	LA
E Longmeadow	MA
Los Angeles	MD
University of California Davis	IL
Shenandoah	IN
Westover	WV
Lindenhurst	IL
Antonia	MO
Parkertown	NJ
Graceton	PA
Redd	WA
Providence	OH
Baltimore	PA
Trenton	IA
Tennerton	WV
Roselawn	OH
Center	NC
Dixie	LA
St. Charles	IL
Flower Mound	CA
Boiling Springs	SC
Madison Hts	MI
Clifton	PA
North Fork	PA
Shell Beach	LA
Wailea-Makena	HI
Devore Heights	CA
Mt Oliver	PA
San Francisco	IA
Scranton	MA
Harahan	LA
Castle Hills	TX
Philadelphia	MI
Avondale	MO
Monte Alto	TX
Elkridge	CA
Colonial Heights	TN
Lincoln	ND
Saint Louis	IL
Saratoga Spgs	NY
North Potomac	MD
Rockbridge	WI
Peters Township	PA
Wall Street	NY
Faribault	NY
Boston	FL
Avon	ME
Twin Groves	AR
King	AR
Plum Springs	KY
Little Rock	VA
Luther	MT
Lake Katonah	NY
Upper Nyack	NY
Baiting Hollow	NY
Conesville	IL
Ste. Genevieve	MO
Lynnville	IL
Raleigh	NY
University Park	MD
Lowell	ME
Mt. Vision	NY
Big Creek	MO
Wescosville	PA
Rock Mills	AL
Chicago	CA
Galesburg	DC
Jbphh	HI
Trainer	PA
Mt Carmel	TN
Fort Worth	CO
Oaklevel	VA
Topsham	VT
Arlington	WV
Port Huron	ME
Fort Canby	WA
Twin Lakes	ID
Woodland	DE
Leland Grove	IL
E Rochester	NY
Buck Grove	IA
Esto	FL
Johnsburg	WI
Fort Myer	VA
White Sands	NM
Vaughan	NJ
Hialeah	MD
Wake Crossroads	NC
Masaryktown	FL
Big Oak Valley	CA
Harcourt	OR
Orleans	MN
Northfield	WI
East Cleveland	OH
Dundee	WI
Redbush	KY
Vancouver	NY
Guilford	VT
Fisherville	MA
Thompson	MI
Sherman	ME
Selkirk	MA
Neptune City	NJ
Rock Valley	NY
Allegheny	PA
Chitwood	OR
Libertyville	NY
Bayonet Point	FL
Vc Highlands	NV
Thompson	NC
Load	KY
Fullerton	PA
Landaff	NH
Glendale	NY
Southside	AR
Point Judith	RI
Logan	CT
Castle Shannon	FL
Layton	GA
Wrentham	IN
Wauwatosa	WI
San Juan	CA
Paradise	DE
Monico	WI
Ridge	VA
Highland Park	TX
Toronto	DC
Sulphur	NV
Thealka	KY
Lakeshore	FL
Deerfield	MT
Dauphin Island	MS
Cove Point	MD
Kirkland	TN
Wilmington	MD
White Bear Tp	MN
New Orleans	MS
Stone Head	IN
St. Donatus	IA
Burlngtn Twp	NJ
Vernon	OK
North Bay Vlg	FL
China Village	ME
St. Francis	SD
York Corner	ME
Jess Ranch	CA
North Huntingdon	PA
Elmwood Place	OH
S Hamilton	MA
Astoria	CT
Paddock Lake	WI
Fairview Hts	IL
Sydney	AZ
Madrid	CO
Grayland	OR
Claycomo	MO
Rye Brook	NY
Portola Vally	CA
Sandy River Plt	ME
Bermuda	LA
Powhatan Point	WV
Newport Ctr	VT
Westampton	NJ
Reading Station	PA
Bardonia	NY
University of California Davis	MO
Fairmount Heights	MD
Sandestin	FL
Camp Connell	CA
Park City	KS
Thousand Plms	CA
Round Lake Beach	IL
Cedar City	IL
Albuquerque	CT
Windsor	AL
Nolin	KY
Fruit Heights	UT
Memphis	CA
Sunnyvalley	OR
Togus	ME
Heber City	NV
Manhattan Beach	MD
Arden	TX
Holly Springs	NY
Chuckatuck	VA
Tusculum	TN
Wilpen	PA
Southwick	CT
Lemington	NH
Witcher	WV
E Waterboro	ME
Quarryville	FL
Urbana	MD
Whetstone	AZ
Yabucoa	FL
Romulus	TX
Tiburon	CA
Horn Lake	TN
Woodlawn Park	OK
Hiattville	KS
Shaftsbury Center	VT
Old Spring Hill	AL
Embden	ME
Oak Grove	GA
Sherando	VA
Summerfield	OK
Garden City	CO
Westfield	ND
Fayette	NV
Exeter	MD
Tomball	OH
Mt. Laurel	NJ
Aguadilla	WA
Rockwell City	OH
Kettering	MD
Oliverea	NY
Gretna	AL
Jersey Village	TX
Central City	SD
Staten Island	NJ
St Elmo	IL
Startown	NC
Lily	SD
Hartmansville	WV
Asheville	RI
W Springfield	MA
Batesburg-Leesville	SC
Lk In The Hls	IL
East Newark	NJ
Pine Springs	MN
Fairview	AR
Hawthorn Woods	IL
Shawnee	KS
Cogan Station	NC
Valley	PA
Gosport	NH
San Tan Vly	AZ
Tewksbury	NJ
Addison	VT
Chelmsford Center	MA
Canelo	AZ
Salinas	FL
Meadowbrook	PA
Village Of Indian Springs	OH
Pennville	PA
McChord Afb	WA
Rutland	WI
Miramar	FL
Hartford	MN
Cove Neck	NY
Dinkey Creek	CA
Duck	NC
Egg Harbor Twp	NJ
Austin	MD
St Stephns Ch	VA
West Collingswood	NJ
Alton	ME
Lake Los Angeles	CA
Chicago	CO
St Martinvlle	LA
Marshallton	PA
Randolph	MO
Silver City	AZ
Titusville	MN
Bluewell	WV
Buffalo Springs	ND
Brown Deer	WI
Mt. Vernon	WA
Niederwald	TX
N Charleroi	PA
Smith Island	MD
Richmond Heights	MO
Dovertown	AL
Searcy	NC
Galvez	LA
Stiles	TX
South Kingstown	RI
Eddyville	NY
Royalton	NY
Chelyan	WV
Loveladies	NJ
West Bristol	PA
Bardstown	VA
Pickensville	AL
Springdale	MD
Toronto	MN
Barton	SC
Zion	MD
Port Canaveral	FL
Westgate	NY
Jeffersontown	KY
Lamont	MS
Mt. Salem	NJ
Big Creek	ID
Vandling	PA
Devine	CO
Old Brookville	NY
W Carrollton	OH
Meadow Lakes	AK
Johns Creek	GA
Menands	NY
Boulder	IA
W Des Moines	IA
Waggaman	LA
Cape May Ch	NJ
Riverview Manor	NJ
Palm Springs	DC
Rollingwood	TX
Allentown	AL
Escanaba	MD
Memphis	FL
Berlin	VT
Cedar Point	NC
Hulberton	NY
Sagamore Hls	OH
E Dummerston	VT
New Rochelle	CA
Seboyeta	NM
Washington	MN
Socorro	TX
Glendon	PA
Tinsman	AR
Silver Spring	MN
Ferndale	MT
Fort McPherson	GA
Sutton	NH
Concordville	ME
Des Moines	MS
East Farmingdale	NY
Voorhees Township	NJ
Gary City	TX
Somerset Ctr	MI
Vega Baja	FL
Williams Grv	PA
St. Ignace	TN
Winona	WI
Meacham	NY
Meggett	SC
St. Joseph	MI
Frankville	IA
Micco	FL
Asbury	IA
Mt. Solon	VA
New Pt Richey	FL
Chapel Hill	TX
Rockford	NC
Mililani Town	HI
Canaan Valley	WV
Timberline Lodge	OR
Rushford	WI
Lockhart	IN
Copley	OR
Portland	DC
Worthington Hills	KY
Winchester Bay	OR
Espanola	FL
Riviera Beach	FL
New Hamilton	MS
Spring	CA
Seattle	OH
Canton	CA
Switzerland	FL
Belleair	FL
Pt Orange	FL
Harbison Canyon	CA
St. Louis	NE
Runaway Bay	TX
Metal	PA
Skidmore	MD
Edgemoor	DE
North Chittenden	VT
Fruitvale	CO
Adelino	NM
Orlando	WA
Strafford	PA
Del Rey Oaks	CA
Dimondale	MO
Pleasant Lane	SC
Deblois	ME
Ladue	MO
North Lakeport	MI
Ft Collins	CO
Quihi	TX
Cross Lanes	WV
Prospect	VT
Haddam Neck	CT
Rocky Mount	MI
Havana	GA
Harris	TX
Rancho Viejo	TX
Meridian	MI
Commercial Pt	OH
Lighthouse Point	FL
Ludlow	KY
Preuss	CA
Williamsburg	AL
Fort Coffee	OK
Milwaukie	OR
Sturgis	OH
Dix Hills	CA
Brokenstraw	PA
Wlks Barr Twp	PA
Prairie	ID
Stark	NH
Smiths Station	AL
Norway	NY
Washington Twp	NJ
Kalamazoo	OH
Mount Chase	ME
Dona Ana	NE
New Monmouth	NJ
McDonald Obs	TX
Chestnut Ridge	NY
Upperville	NY
Sugar Grove	AR
Chapel Hill	GA
New Washoe City	NV
Cary Plt	ME
Cavour	WI
Catherine	NY
Solon	NY
Stewart Manor	NY
Browntown	VA
Plantation	FL
Homer	PA
Fern Park	FL
Washingtonvle	NY
Chula	VA
Parsippany	IL
Washington	OR
Oxon Hill-Glassmanor	MN
Fort Carson	CO
Parsons	PA
Taylors Bridge	NC
Ashford	NJ
St. Anthony	MN
DeSales University	PA
Colonial Hgts	VA
Paineville	IL
Bingham	NM
Mendota Heights	MN
Dundee	CA
Willimantic	ME
Brookside	UT
Shawnee Hills	OH
Stratford	NH
Bartlett	PA
Plains	PA
Pepper Pike	OH
St. Charles	ID
Napier	TN
Highland Fls	NY
Brampton	ND
Uppr Blck Edy	PA
Palisades Pk	NJ
Agoura	CA
Port Clarence	AK
Wheeler	WV
Stock Island	FL
North Las Vegas	CT
Stevens Creek	AR
Cambria Hts	NY
Baldwin	KS
San Jose	MP
Merriam Woods Village	MO
New Chicago	IN
Crystalaire	CA
S Farmingdale	NY
Vlg Of Lakewd	IL
Wilkes Barre Township	PA
Woodfin	NC
Granite	MD
Nashville	OK
Mountain Village	CO
Lexington	OH
Oldsmar	SC
Blackwell	AR
Lake Shore	MD
Eaton	NH
Leon Valley	TX
Jonesville	FL
Mount Tabor	VT
Vernon	CT
Warrenville	CT
Willimansett	MA
Old Lexington	AR
South Granville	NY
Grovetown	FL
Browning	KY
Highland Plt	ME
Shannon Plaza	NC
Northfield	MI
Orchid	FL
Lynchburg, Moore County	TN
Ocean Grove	MA
Hurstbourne Acres	KY
Tewksbury Twp	NJ
Fairmount	MD
Cedarville	MA
West Amherst	NY
Darrington	OR
Chesterbrook	PA
Fields	LA
Carneys Point	NJ
Medina	VA
Mableton	CT
Florham Park	NY
Lower Paxton	PA
St. Bonifacius	MN
London	WI
Farmington	WI
Portland	AZ
Erdenheim	PA
Fountain Vly	CA
Daniels	MD
Copper Canyon	TX
Mt Carmel	PA
Rock Mill	OH
Valley Grande	AL
Englewood	IN
McAllen	MD
Spring Lk Pk	MN
Meta	KY
Oakville	IL
Optima	OK
Indianapolis	IL
Raleigh	PA
Glendale	CO
Mitchell	IL
West Cornwall	VT
Willeys	IL
Redmond	TX
Monkey Island	OK
Northtown	KY
Toboyne	PA
Stagecoach	TX
Elba	MN
Maysville	AL
Cliffside Park	NY
Bethlehem	NY
Garden Pr	IL
Kabetogama	MN
Dardenne Prairie	MO
Mt Union	PA
Wheatley	KY
Bay View	MI
Moreland Hills	OH
Jupiter	CO
Lowell	IA
Tahoe Paradise	CA
Finneytown	OH
El Mirage	CA
Salunga	PA
Fontanelle	NE
Amherst	NY
Five Forks	VA
Tucson	WI
Twentythree	AR
Aurora	KY
Borculo	MI
Dot Lake	AK
Allen	LA
Mossy Creek	VA
East Beaver Bay	MN
Seattle	WI
Harrietstown	NY
Oakbrook Terrace	IL
S Charleston	WV
Sheffield Lake	MI
Quail Valley	CA
Bible Grove	MO
Vamo	FL
Robertville	SC
Powell	AL
South Congaree	SC
Arlington	MD
North Branch	TX
Vineland	CO
East Grand Rapids	MI
Mars Bluff	SC
Neillsville	IL
Elsmere	KY
Luber	AR
Highland Park	CA
Glazier	TX
Dwyer	NM
Mechanicsvlle	IA
Floyd	AR
Cleburne	ID
Lake Como	NJ
St. Francis	WI
Chamblee	GA
Madison	ID
Port Vincent	LA
Blackduck	NE
Northumberland	NH
Algonquin	AZ
Crestwood	IL
Bellingham	TN
Port Acres	TX
Phoenix	IL
Eagleville	OH
Indianapolis	AZ
El Cerro Mission	NM
Lakeside Park	KY
Greenwood	ME
Sardis City	AL
Sissonville	WV
Canton	MD
Galchutt	ND
Fletchers Landing Twp	ME
Falcon	CO
Graterford	PA
New Orleans	AK
Helechawa	KY
Harmon	OH
Amherst Jct	WI
Unadilla Forks	NY
Grand Jct	CO
Miami	MD
Hodgdon	ME
Sheldon	MI
Kenneth City	FL
Sanctuary	TX
Liberty	UT
Madera	MT
Wheeler	KS
Yorktown Hts	NY
Carnot-Moon	PA
Jewell Junction	IA
St. Cloud	MN
Howardwick	TX
Combine	TX
Atlanta	CA
Arthur	WI
Seabrook	MD
Roselle	OH
Elmwood Park	WI
Enchanted Oaks	TX
Collierville	FL
Cleghorn	WI
Hideaway	TX
Calhoun	AR
Superior	CO
Peshawbestown	MI
Purcell	KS
Hidden Springs	ID
Mt Sterling	WI
Westport	WI
Platte Woods	MO
Silver Ridge Twp	ME
Watts	CA
W Melbourne	FL
Lakewood Ranch	CT
Shadwell	VA
New Hope	MN
Bayview-Montalvin	CA
Bristol	OH
N Providence	RI
Iowa	CT
Yonges Island	SC
West Lynn	MA
Carrabassett Valley	ME
Bel Air	CA
Melrose	AR
Shelton Laurel	NC
Midway	NC
Tennessee	TN
Murrells Inlt	SC
Capitol Heights	DC
Downers Grove	MI
Fayetteville	IL
St David	IL
Fenner	NY
Mordansville	PA
New Diggings	WI
East Harwich	MA
Brookside Village	TX
Sandalfoot Cove	FL
Pontotoc	OK
Russellville	MS
Hoyt	NE
Oregon Hill	PA
West Marlboro	VT
San Francisco	AL
Pilgrim Gdns	PA
Hellam	PA
Sharon Center	IA
St. Simons	GA
Hampton Beach	NH
Hales Location	NH
Martinsburg	MD
Belvidere	NY
Houck Meadows	OH
Lenox	MI
Butztown	PA
Selfridge Angb	MI
Lamar	TX
Lake Kiowa	TX
Beverly Hills	TX
Ord	IA
Armstrong Mills	OH
Detroit	CA
Herndon	MD
South Chittenden	VT
Rising Sun	PA
Mount Angel	FL
Waterbury	NV
Becida	MN
Plymouth	MN
Shoreline	TX
Philadelphia	WV
Atmautluak	AK
Pecan Island	LA
Salt Lake City	CA
St Paul	TX
Crazy Horse	SD
Brookwood	OH
Wadsworth	MI
Warrenville	NJ
Yosemite	CA
Forest Grove	KY
Melvins	DE
Star Valley	AZ
Hanover	OH
Hilltop	MN
Neffsville	PA
Laurel Springs	NJ
Grandview	OH
Tinton Falls	NJ
N Ridgeville	OH
Silva	ND
W Los Angeles	CA
Prichard	AL
McMillin	WA
Lima	PA
Stack Town	PA
Ctr Moriches	NY
Locust	NJ
Warwood	WV
Brooklyn	OH
North Kensington	MD
Pickaway	WV
Troy	OR
Vadnais Heights	MN
St Mary	KY
Becknerville	KY
Fanning Springs	FL
Schererville	MN
N Wilkesboro	NC
Arecibo	MI
Anaconda-Deer Lodge County	MT
Layton	MD
Cincinnati	IN
West St. Paul	MN
Carrollwood	FL
Wawona	CA
Waipio Acres	HI
Pueblo Depot Activity	CO
Kew Gardens Hills	NY
Churchville	PA
Hunts Point	WA
Nortonville	ND
N Belle Vernon	PA
Greenfield	KY
Stillwater	WI
Andice	TX
Plantation	KY
North Madison	OH
Grand Beach	MI
Heath	TX
Brevard	FL
Buffalo	MD
Tuckahoe	VA
Freeman Twp	ME
Sprtsmn Acres	OK
Tucson	MD
Olivet	NJ
Williamsburg	NC
S Hackensack	NJ
Columbus	FL
Butler	NY
Au Sable	MI
Brookfield	MD
Paxtang	PA
Val Verde	CA
Prowers	CO
Newtok	AK
Commerce	TN
Port Bailey	AK
Webster	KS
Hazlet Township	NJ
Freedom	OH
Gorham	MA
Kolin	LA
Scotlandville	LA
Franklin Township	NJ
Colgate	ND
Garfield Heights	OH
East Dundee	IL
Portage Creek	AK
Upper Montclair	MA
Roxbury Twp	NJ
Berry	WI
Grand Rapids	NE
Albuquerque	IL
Swan River	MT
Rensselaer	MO
Schley	IA
Everett	OH
Brickerville	PA
Tyrone	KY
Marlow Heights	MD
Eureka	MN
Harmony	FL
Old Tappan	NJ
Hamlet	AR
Bolton Valley	VT
Acoma	NM
Charles City	TX
Mt Union	IA
Francisville	KY
Manville	IL
E Cleveland	OH
Melville	PA
Miller	OH
Collier Twp	PA
Ocean Pnes	MD
St. Johns	AZ
Bloomfield	MI
Virgelle	MT
Bangor	NY
Granite Shoals	TX
Calgary	ND
Indian Island	ME
Parker	TX
Sunny Isles Beach	FL
Albuquerque	TX
Calverton	MD
Hilliardston	NC
Selz	ND
Gold River	CA
Wanilla	MS
Rncho Domingz	CA
Bath Center	OH
Cranberry Township	PA
Allenstown	NH
Sea Ranch Lakes	FL
Fort Lauderdale	OH
Tiki Island	TX
Treasure Island	FL
Churchtown	PA
Greenfield Twp	ME
Garden City	SC
Malden	WV
Santa Clarita	GA
Sharpsburg	VA
Southside	AL
Lookout Mtn	TN
Eureka	NC
Jicarilla	NM
Webberville	TX
Bracht	KY
Pipestone	SD
Holly Hill	FL
Palmer Heights	PA
Saint George	VT
Knox	ME
Stoney Beach	MD
Kidville	NC
Boulevard	NY
Newington	NH
Rig	WV
Fargo	MN
Olmsted Twp	OH
Judd Hill	AR
Bartlett	IN
Reiles Acres	ND
N Chelmsford	MA
Fond Du Lac	MN
Aitkin	WI
Del Haven	NJ
Brentsville	VA
Pleasant View	UT
Pine Ridge	FL
Normandy	IL
Kansas City	ND
Kenmore	NY
Blackburn	NC
Dalark	AR
Patapsco	MD
Newberg	MA
Minnesott Beach	NC
Lake St. Louis	MO
Bache	OK
Waikoloa Village	HI
Large	PA
Royal Lakes	IL
Meadows Place	TX
Fairport Harbor	OH
Perrine	FL
Mill City	NV
Amity Harbor	NY
Nippa	KY
Rtp	NC
Mt Olive	IL
Lake Tapawingo	MO
Linlithgo	NY
Bozeman	CA
North Swanzey	NH
South Holland	IN
St. Francisville	IL
Wantage	NJ
Lansing	CA
New Post	WI
Metcalf	GA
Livingston	PA
East Lansing	MN
Commerce	NE
Sacramento	MD
Taylors Bridge	DE
Green Bottom	WV
Taylor Lake Village	TX
Star City	WV
Half Moon Bay	WA
Pine Haven	WY
Radley	KS
Camp Springs	MD
West Hanover	PA
Lathrup Village	MI
Westford	PA
Meridian	PA
N New Portland	ME
Falcon Heights	MN
Wendover	NV
Willington	SC
Fort Lauderdale	AL
Cook Sta	MO
Gunnison	NE
Embden	ND
Corona De Tucson	AZ
Avondale	OH
Williamsville	NY
Little Heaven	DE
Cleveland Heights	OH
Mountain Lks	NJ
Krugerville	TX
Mulberry	KY
Burlington	VA
Ruch	OR
Hudson	PA
Hoytsville	UT
Cooper City	FL
St. Paul	OR
Washington Ch	OH
Rochester	NE
Belden	ND
Rancho Murieta	CA
Cross Keys	SC
Peoria	OK
Dix Hills	ME
Batavia	TX
Arcola	GA
Leander	NY
Jefferson Cty	TN
Mt Blanchard	OH
North Windham	ME
Eagle Mountain	CA
Bel Aire	KS
Prescott Vly	AZ
Brentwood	NH
Cudjoe Key	FL
Ponce Inlet	FL
East Liberty	PA
Manchester-By-The-Sea	MA
Washington Township	MI
Oak Island	NY
Youngville	TN
Woolsey	GA
Felicity	CA
Weston	LA
Spring Glen	UT
Oswego	OR
Beaconsfield	MA
Diomede	AK
Claysville	OH
Jonesboro	OK
Wurtland	KY
Spotville	AR
Hopewell	IL
Taylor Mill	KY
Edge Hill	GA
White Day	WV
Damiansville	IL
Cherry Grove	NY
West Reading	PA
Athens	IA
Boise City	ID
Bovina	WI
Eggertsville	NY
Green Springs	KS
Berville	MI
Shreveport	IL
Pleasant Vly	MO
Keystone	CO
Cooper	ME
Green Point	PA
Allouez	WI
Beargrass	NC
Rolling Hills Estates	CA
Pittsfield	CT
Sidney	FL
Eastern	VA
Aldan	PA
Naperville	TX
Webbs Cross Roads	KY
Iowa City	MD
Winfield Park	NJ
Lackland AFB	TX
Jennings	MO
Moore	OK
Salt Lake City	WA
Madison	TX
Jbsa Ft Sam Houston	TX
Berkeley Lake	GA
Blanchard Twp	ME
Irondale	CO
Pumpkin Center	AZ
Slana	AK
Ocean Acres	NJ
Mount Kisco	CA
Silver City	SD
Garden Ridge	TX
Lawrence Park	PA
Kirkwood	MO
Lester	PA
Selden	VA
Jeffersonville	TN
Copley	OH
Hammetts Crossing	TX
Carpentersvle	IL
Covington Twp	PA
Lauderhill	FL
Moorefield	AR
Surfside	FL
Swissvale	PA
Sand Lake	FL
Southgate	KY
South Enola	PA
Merricourt	ND
Hazen	PA
Coon Rapids	OK
Doraville	GA
Oak Hills	CA
Niskayuna	NY
Gainesville	TN
Milford Mill	MD
East Pennsboro	PA
San Francisco	MD
Fair Oaks	PA
Drummond Is	MI
Huntington Beach	NJ
Farmers Brnch	TX
Needham Heights	MA
Del City	OK
Sappington	MO
N Potomac	MD
Omaha	CA
Spring Valley	AZ
Alafaya	FL
Dewees Island	SC
Jefferson	LA
Monticello	LA
Shiloh	IL
Gahanna	OH
Southport	IN
Shepherdsville	MD
West Fairfield	PA
Gillisonville	SC
Chicago	NE
Humacao	NY
Philadelphia	MN
Fife	WA
New Hope	MI
Sterling Hts	MI
Johnsburg	IL
Mount Snow	VT
Ballard	CA
Chatsworth	TN
Bolton	VT
Salisbury	DE
Saint Simons Is	GA
Hickory Creek	TX
Rio Bravo	TX
Parkersville	PA
South Yankton	NE
Richmond Heights	OH
Marche	AR
Holly Grove	VA
Agua Dulce	CA
Lakewood Ranch	FL
St. Gabriel	LA
Apple Valley	UT
Wm Penn Anx W	PA
Manor	DE
Inkster	CT
Grand Rapids	ND
Scranton	KY
Kennesaw	MD
Madelia	IL
Monmouth Jct	NJ
Washoe	NV
Truscott	TX
Rose Haven	MD
Twn And Cntry	MO
Willow	PA
Fairmont City	IL
Westport	MN
McKnight	PA
Mission	FL
Centerville	MN
Eldorado	IA
Lauderdale	MN
Snead	AL
Topeka	OR
Bowers	DE
Boone	KY
Oulu	WI
Colorado	CO
Center Point	AR
Patchogue	MA
Rio Blanco	CO
Malden	TX
Ophir	UT
Southbridge Town	MA
Riverview	WY
La Grange Pk	IL
Hopkinton	NH
Kansas City	MI
Elwood	NY
Allagash	ME
Kirksville	UT
Cane Creek	AR
Pine Grove	KY
Graeagle	CA
Desloge	MO
Milwaukee	IN
Sand City	CA
Italy	NY
St Lucie West	FL
Mussey	MI
South Toms River	NJ
Lake Landing	NC
Woodmere	OH
Ponce	FL
Centerville	WI
Cloud Lake	FL
McCartyville	OH
Dunlap	OH
Fairfield	NY
Pampa	OR
Westwood Hls	KS
South Attleboro	MA
Evaro	MT
Vernon City	MI
Stone	MA
Chatham	KY
Frenchport	AR
Eckley	PA
St. Peters	MO
New Allen	KY
Los Angeles	KY
Elwyn	PA
Elizabeth Township	OH
Fountain Hill	NJ
Villas	FL
Oma	MS
Stafford Twp	NJ
Moreau	NY
Brush Harbor	VA
Black Jack	MO
Surf City	GA
Fairbanks Ranch	CA
Evesham	NJ
Bear Creek Tw	PA
Largo	MD
Moss Bluff	LA
Myrtletown	CA
Columbia	OH
Wailuku	IL
Big Lake	WA
North Chester	MA
Cypress Mill	TX
East Buffalo	PA
Milwaukee	IL
Oconomowoc	NJ
Roseville	WV
Enoch	UT
Cherry Flats	PA
Stowe	PA
Homer	OK
Summerdean	VA
Bellevue	PA
Garden City Beach	SC
Yonkers	IL
Hepburn	IA
Milton	GA
North Wildwood	NJ
St. Olaf	IA
Holland	PA
Deering	NH
Weddington	NC
Wrightwood	IL
Belleair Bluffs	FL
San Antonio	PA
Mt Vernon	TX
Godley	IL
Lago	ID
El Segundo	NJ
Upper Makefield	PA
Baldwin	FL
Ralston	NE
Mc Dermitt	OR
Niagara Falls	CA
Chickasaw	IA
Hollins	VA
Hatboro	KY
Western Sprgs	IL
Papinville	MO
Uppr Marlboro	MD
Murphy	IA
Manchester Tw	NJ
Germantown	SD
Bavaria	KS
Moccasin	AZ
Fredericksburg	TN
East Orange	VT
Clay	AR
South Charleston	WV
University Pk	FL
Overland	MO
N Hollywood	CA
Teaneck	IN
Raymond	GA
Birmingham	MO
Ensley	AL
Wellington	ME
Jamestown	AR
Saint Joseph	IN
Linthicum	MD
Burien	WA
Port Fourchon	LA
Pinckard	KY
Liberty Township	PA
Sunrise	PA
Pupukea	HI
Leucadia	CA
Hahns Peak	CO
Star Valley Ranch	WY
Chattanooga	GA
Eddiceton	MS
Cloudland	GA
Miami Springs	FL
Wolverine Lake	MI
Sarasota	TN
Queen Valley	AZ
Vervilla	TN
Stockport	NY
Fletcher	VT
Sprngfld Gdns	NY
Edmonton	CA
Byron	ME
Southfield	CO
Bridgetown	VA
Newport	DE
Gary	WA
Woodford	VT
Pleasant Pln	OH
Nunam Iqua	AK
Fairfield Center	ME
Irondale	AL
Palmer	PA
Whistler	DE
Capps	FL
Hughestown	PA
St. Johnsville	NY
Pueblo West	CO
Little Washington	PA
Orlo Vista	FL
Flanders	NY
Aberdeen	MI
Burns Harbor	IN
Loma Linda	IL
Silver Sands Beach	ID
Upper Falls	WV
North Miami	FL
Oriental	PA
Mill Iron	MT
Youngstown	MO
Lake City	GA
Hamburg	WI
Hobart	IL
Georgia	MI
Abac	GA
Mount Washington	PA
Adair Village	OR
Los Angeles	NC
S Portland	ME
Highlandtown	MD
Pt Pleasant	PA
Pleasant Hill	IA
Tabor City	SC
Tabernacle	NJ
Stewartstown	NH
Vancouver	KS
Detroit	GA
Ruston	WA
Yellville	GA
Wynnedale	IN
Rockaway Pt	NY
Saint Paul	AK
Clifftop	WV
Newhalem	WA
North Brunswick	CA
Lewisburg	NY
Mt Pleasant	MI
Elon	NC
Ann Arbor	CA
Boothwyn	PA
Edgewood	WA
Seven Corners	VA
Lafayette Hl	PA
Andover	PA
Lansing	WI
Mineral Ridge	CT
Fort Totten	NY
Roosevelt Island	NY
Ft Wainwright	AK
Crooked River Ranch	OR
Bow Mar	CO
St. Augustine	FL
Elk City	WV
Clear Lake	IN
Mooresville	TN
Manheim	TX
Linthicum Hts	MD
Corona	AZ
Richford	WI
Capitol Island	ME
Summerford	OH
East Stroudsburg	TX
Champions Gate	FL
Port Barrington	IL
Mt Pleasant	IA
New Orleans	NE
Marathon City	WI
Central Sq	NY
Balch Camp	CA
San Antonio	CA
Orienta	OK
Kirksville	AZ
Ellicott City	MA
Old Lyme	IA
Venice Center	NY
New Shoreham	RI
Fort Snelling	MN
West Homestead	PA
St Lucas	IA
Westminster	NV
E Palestine	OH
Walworth	WY
Tampa	MD
Wolf Coal	KY
Redstone	CO
Devonshire	CA
Moravian Fls	NC
Highgate Falls	VT
Maryland City	MD
Creedmoor	TX
Fullerton	TN
New Lyme	OH
Panama City Beach	NH
Vancouver	KY
Rankin	PA
Anchorage	PA
Mount Pleasant	AL
Macwahoc Plt	ME
Savannah	MI
Cahaba Heights	AL
Tilton Northfield	NH
Pacific Beach	CA
Calumet Park	IL
Corralitos	CA
Fort Worth	TN
Pt Pleasant Beach	NJ
Ketchikan	IL
Fort Lewis	WA
Briery	VA
Sioux Falls	CA
Bridge City	LA
Elk Grove Vlg	IL
Ink	OH
Paxville	SC
Morro Bay	CO
St. Charles	GA
Cottonwood Heights	UT
San Tan Valley	AZ
Edgewood	FL
Franklin Ctr	PA
Panola	IL
Highland Bch	MD
Marrowstone Is	WA
Michigan	MI
Cudahy	CA
Langdon	KS
Berthoud Falls	CO
Forsyth	NY
Opal Cliffs	CA
Blaisdell	ND
Alexandria	NY
Ashwood	TN
New Site	AL
West Fairview	PA
Newark	AZ
Foraker	IN
Plymouth	LA
Solvay	NY
East Warren	VT
Burrowsville	VA
Lebanon	DE
Pigeon	WV
Mescal	AZ
Scarborough	CO
Brigham City	ID
Onondaga	NY
Carolina	IL
Washington	WA
Crescent	MO
Noank	CT
Frenchtown	OH
Drakes Corner	VA
Clarksburg	IL
Gulf Stream	FL
Peytonsville	TN
West Delray Beach	FL
Hickory Tavern	SC
Bellaire	WV
Holder	IL
Twin Lakes	AZ
Black Creek	GA
Troy	MA
Spring Meadows	OH
Hayti Heights	MO
East Williston	NY
New Orleans	NY
St. Cloud	FL
Forks Township	PA
Virginia Beach	CA
Fairview	GA
Trout Valley	IL
Liberty Twp	OH
Norman	MA
Glendora	MI
St Clair	MN
Frenchtown Twp	ME
Orchard Beach	MD
Strawberry Pt	IA
Bentonville	OK
Rochester	AZ
Nyesville	PA
Yetter	IA
Christmas	MI
Dexter	MA
Social Hill	AR
Tool	TX
Vancleave	MS
Murphy	MO
King City	OR
Naguabo	FL
West Norriton	PA
Linn Valley	KS
St. Joseph	MN
Lake Buena Vista	FL
Scottsdale	MN
Tracy	MO
Truesdale	MO
Little Rock	TX
Lincoln Center	KS
Salt Lake City	NV
Indian Land	SC
Okolona	KY
Coon Rapids	MN
Britton	TN
Thomson	NY
North Cape May	NJ
Ogden Dunes	IN
North Hadley	MA
Puhi	HI
Algoma	WV
Creston	LA
Spruce Hill	PA
Lucerne	WA
Glenrio	NM
Oak Park	GA
San Juan Capo	CA
Mangohick	VA
Warrenton	TX
Danville	MO
Wolfeboro	IN
Smalls Crossroads	NC
Birmingham	TX
Amherst Center	NY
McGuire Afb	NJ
Verhalen	TX
London	GA
Damascus	OR
Potters Hill	NC
Country Club	MO
Sunshine	KY
West Burlington Township	PA
Gallatin	NY
Gardner	TN
Villano Beach	FL
Lincolnton	NY
Riley Hill	NC
Beaver	WI
Ann Arbor	MD
Carlisle Brks	PA
The Colony	MD
Prt Hueneme	CA
Fort Worth	VA
Columbus	AZ
Mt Washington	PA
Rossmoor	CA
Van Buren Twp	MI
Frye Island	ME
Milo Center	NY
Panton	VT
Lakeway	TX
Mirror Lake	NY
Edgewood	NY
Harbison	IN
Toa Baja	FL
Silo	OK
Roslyn	PA
Wheat Ridge	MD
St. Joseph	WI
Merrill	NY
Point Pleasant	NJ
Elizabeth Cty	NC
Guttenberg	NJ
Hartford	MD
Mount Selman	TX
Pt Charlotte	FL
Twin Lakes	IA
Valley Vlg	CA
Laverock	PA
Kenockee	MI
Shelby	SC
Bexley	OH
Indian Creek	IL
Wethersfield	WA
Staunton	OH
Charlottesville	AL
Upper Montclair	NJ
Green Brook	NJ
Landusky	MT
Baileys Hbr	WI
Overland Park	MO
Wildwood	MO
Ruidosa	TX
Homestown	MO
Lemington	VT
North Valley	NM
Saint Louis	TX
Shady	NY
Gibraltar	PA
Burlington	OH
Navilleton	IN
St Joseph	KY
Dixon	GA
Grosse Pointe Woods	MI
Bloomfield	VT
Zigzag	OR
Colchester	VA
Acton	IN
Slaughtervl	OK
Center Point	AL
Flintridge	CA
Kellersville	NC
Prospect	ME
Seatac	WA
N Syracuse	NY
Orlando	MI
Sauk Village	IL
Dyer Brook	ME
Pearisburg	TN
Yakima	IA
Shiremanstown	PA
Woodcliff	NJ
Sulphur Well	KY
Mountain City	TX
Brookfield	NH
Eleven Mile Corner	AZ
Ewington	OH
El Paso	GA
Boger City	NC
East Windsor	NJ
Los Angeles	IL
Bettendorf	IL
Middletown	GA
Shawangunk	NY
St Albans	NY
Mauldin	AR
Cathedral Cty	CA
Poway	KY
Gay Hill	TX
Bay Harbor	MI
Sweetwatr Sta	WY
Roscoe	NE
Tequesta	FL
Lutherville	AR
Ingram	PA
Canyon Lake	CA
Elvins	MO
McClellandville	DE
North Patchogue	NY
Lavale	MD
Timberwood Park	TX
Portola Hills	CA
Winnipeg	VA
Richmondale	PA
Kansas City	OR
Fulton	TN
Union Gap	WA
W Valley City	UT
Orange	NH
Maxville	FL
Lake Suzy	FL
Shrewsbury	WV
Riverdale	FL
Murphy	TX
Cheapside	VA
Unityville	SD
Wm Penn Anx E	PA
Clarendon Hls	IL
Renton	NE
Sparks	MD
Windcrest	TX
Moxee City	WA
Prospect Park	MN
Third Lake	IL
Old Alabam	AR
Reserve	KS
West Trenton	NJ
West Pennsboro	PA
Ft Oglethorpe	GA
Cameron Park	SC
New Canaan	NY
Wymer	WV
Belvedere	SC
E Brookfield	MA
Kennett Square	DE
Mount Weather	VA
Harts Location	NH
Cullman	CA
Pleasant Hill	AR
Festus	IN
Blaine	MN
Donaldson	PA
Trevose	PA
St. Albans	VT
Reynolds	ID
Clintonville	KY
Scott Twp	PA
Whitman	ND
Waubeka	WI
Roswell	ID
Ames	TX
Spring Bay	IL
Ono	CA
East Rancho Dominguez	CA
New York	MI
Orlando	IA
Gallipolis	WV
Cheverly	MD
Calgary	FL
Rocky Ridge	UT
N Brunswick	NJ
Choctaw	MS
Nimrod	AR
Sharonville	OH
Biddleborn	IL
Vicker	VA
Golden Beach	FL
Chicago	TX
Chapel Hill	NY
Trappist	KY
Idaho Falls	PA
Lithia	VA
Rncho Cordova	CA
Avalon	PA
South Florida	FL
E Providence	RI
Hanging Rock	OH
Woolsey	AR
Toulouse	CA
Schuyler	NY
Greenville	AR
Williamsbridge	NY
River Vale	NJ
Oakland	WA
Blooming Grove	PA
Wooddale	DE
Ammon	ID
North Canton	OH
St George	VA
W Farmington	OH
Riley	MI
Cincinnati	AZ
Judson	ND
Albrightsvlle	PA
Milan	NY
Bethesda	IN
Oklahoma City	NY
Edgewater	CO
Shrewsbury	VT
Hiles	WI
West Lakeland	MN
Wolf Creek	MA
Phila	PA
Eros	AR
West Carrollton City	OH
Sugarland	MD
Biggersville	MS
Sanatoga	PA
North Oaks	MN
Washunga	OK
Nicodemus	KS
East Fairfield	OH
Unity Village	MO
Boardman	OH
Minneapolis	WI
Spring Valley Lake	CA
Sutter Creek	WA
Laurelton	NY
Dart	OH
No Ferrisburgh	VT
Boston	OH
New Hartford Center	CT
Pocatello	MD
Placentia	NE
Navarro	TX
Excursion Inlet	AK
N Highlands	CA
Arcadia University	PA
Upper St. Clair	PA
Webster	WV
Jacksonville	MI
Lares	NY
Parkland	WA
Madrid	NM
Norridge	IL
Montrose	WI
Village	OK
Winona	AZ
Charlotte	CA
Mildred	TX
Man	OK
Clearwater	ID
New Hamburg	NY
Fort Myers Shores	FL
Mt Pleasant	WI
Chapman	ME
Millarton	ND
Airway Hgts	WA
Ellett	VA
Colorado Springs	IL
Mission Hills	KS
Pt Canaveral	FL
Ocean City	WA
Treetops Village	MI
Phillipston	MA
Waumandee	WI
Poplar Grove	MN
Erma	NJ
Osnabrock	NV
Altamont	SD
E Dublin	GA
West Gilgo Beach	NY
Giard	IA
The Woodlands	TX
Santa Barbara	OH
Azle	MA
Wingate	PA
Mountain Mesa	CA
St. Michael	MN
Avon Park	MN
Central Vly	NY
Moberly	KY
Camuy	NY
S Kingstown	RI
South Berlin	TN
Davenport	GA
Riverdale	IA
Gowensville	SC
Dallas	IN
Ft Yates	ND
Mineral King	CA
Bland	UT
Richland Hls	TX
Atkinson	ME
Vermont	VT
Floyd Hill	CO
Tiffany	WI
Point Pleasant Boro	NJ
Chapel Hill	CT
Beales	VA
North Little Rock	TX
Cedar Rapids	MD
Davie	IL
East Alstead	NH
Dalworthington Gardens	TX
New Berlin	LA
Augusta	AZ
Delong	IL
Ballardsville	KY
Towner	CO
Perry	UT
Sugar Land	CT
Arbor Vitae	WI
Brandonville	PA
Sussex	WY
Houston	IL
Deadwood	TX
Caswell Beach	NC
Allison	AR
Doaks Crossroads	TN
Benton	ME
Sun River Terrace	IL
Lakeside	TX
North Greenbush	NY
Country Club	WV
Cobden	MN
Grand Island	MI
Tacoma	CA
Daytona Beach Shores	FL
Great Diamond Island	ME
Lodge	IL
Lacour	LA
Worcester	VA
Long Beach	NJ
Bauxite	TN
Clay	MS
Jasper	NC
Silver Spring	DC
Azwell	WA
Millville	IA
Harrington Pk	NJ
East Tawakoni	TX
College Hl	OH
Salt Lake City	AZ
Shelby	NJ
Antelope Hills	CA
Cape Saint Claire	MD
N Parkersburg	WV
Proctor	MN
Poquonock Bridge	CT
Wadsworth	NY
Royalton	VT
Columbia	ME
Calgary	KY
South Chelmsford	MA
Fairlawn	VA
Palmer	KY
Gantt	SC
Cameron Park	CA
Haskell	AR
Shoemakersvle	PA
Piney Grove	AR
Zia Pueblo	NM
Bloomfield	PA
Galmey	MO
Wiloughby Hls	OH
Laurel Hill	LA
Charlotte	ME
W Middlesex	PA
Taft	OH
Barnstable Town	MA
Portal	AZ
Roxbury Crossing	MA
Berlin	MI
Highland	AR
Gulfport	FL
Swall Meadows	CA
Iberville	LA
Clay	MI
Oakland Park	FL
East Hampton North	NY
Orting	OH
Nashville	NY
Lakeville	ME
Murfreesboro	MD
Johnson City	AL
Ft Lauderdale	FL
Coppell	MD
Pittston Township	PA
Lino Lakes	MN
Bevil Oaks	TX
Redding	NV
Milwaukee	FL
Liberty Hill	TN
Beauvue	MD
Gardiner	WY
Malta	NY
River Hills	WI
Brooklyn Heights	OH
Centerville	OH
Lincolnville	SC
Pilesgrove	NJ
Riverdale	NY
Lucas	TX
Elkhorn	TN
Loma Linda	MO
Morton	AR
Bloss	PA
Riceland	OH
Parkman	ME
Pittston Academy Grant Twp	ME
Bellerose Terrace	NY
Delran	NJ
Scipio	NY
Fair Oaks Ranch	TX
N Haverhill	NH
Minden	CA
Saint George	MI
Howell	OH
Simi Valley	TX
Greenwood Village	CO
Hialeah Gardens	FL
Southrn Shore	NC
Cammack Village	AR
Inwood	MD
Summit	WI
Washington Twp	MI
Carrollton	AR
Massapequa Pk	NY
Hingham	OH
Columbia Township	OH
Rossville	OH
Kalaoa	HI
Village Shires	PA
Worthington	OH
Sunset Valley	TX
Chesterfield	MI
Willoughby Hills	OH
La Plant	SD
Lanham-Seabrook	MD
Nine Mile Fls	WA
Kaibeto	AZ
Indianapolis Brm	IN
Helena Valley Northeast	MT
Gardere	LA
Blue Hill	AR
Jersey Vlg	TX
Olivia	TX
Bosco	LA
Abington	NY
Fort Indiantown Gap	PA
Indiantown	SC
Central	PA
Coburn Gore	ME
Kearns	UT
Clarksville	DE
Gustave	SD
Snowbird	UT
Markham	AL
Cedar Grove	MA
Flagstaff	NM
Providence Village	TX
Lester	OH
Congaree	SC
Falmouth	VA
Pipe	WI
Bruce	MI
Yorkana	PA
Ephesus	GA
Rita	WV
Pine Ridge	AR
Shiloh Hill	IL
Bloomingdale	KY
Lake Waynoka	OH
Osceola	IL
Houston	CA
Ormond Beach	SC
Timberlake	VA
Sky Londa	CA
Charlottesville	TN
Weldon Spring	MO
Lake Arrowhead	ME
Elliott	ND
North Union	PA
North Canaan	CT
Saville	PA
Seattle	MI
Glendale	OH
Worcester	TX
Pine Island	MT
Leipsic	DE
Leona Valley	CA
Bartonville	VA
Steelton	PA
Philadelphia	HI
S Weymouth	MA
Blair	CA
Severna Park	TX
Richwood	TX
Talleyville	DE
Saint Martin	OH
Desert View	AZ
Pleasant Hill	TX
Boscawen	NH
Onancock	NY
North Tonawanda	TX
Longs	FL
Pompano Beach	NV
Redstone Arsenal	AL
Desert Aire	WA
Powells Crossroads	TN
Kanodes Mill	VA
Westhampton	MA
West Allis	WI
Toronto	NY
Blk River Fls	WI
McAfee	KY
Houston	CT
Carol City	FL
Poston	SC
Valley Glen	CA
Broken Arrow	TX
Cincinnati	MS
Marblehead	OH
Duboistown	PA
Victoria	NC
Montgomery	NJ
Shellsville	PA
Fond Du Lac	ME
Arago	MN
Hollingsworth	GA
Byram Township	NJ
Melones	CA
Brooklyn Park	MD
Ironshire	MD
Lorane	PA
San Juan	MA
Wyeville	WI
Hokendauqua	PA
Emsworth	PA
New Orleans	AZ
Hootentown	KY
Northport	ME
Obetz	OH
W Bloomfield	MI
Cataract	IN
Upper Arlngtn	OH
Spring Lake Park	MN
Wellston	MO
Eldon	WA
Buford	AL
Yards	VA
Corbin City	NJ
Speed	IN
Haynes	ND
Portage	FL
Grand Chute	WI
Brockway	MI
North Weymouth	MA
Fallen Leaf	CA
Lockhart	FL
Saint James	MI
Power	WV
San Miguel	AZ
La Canada Flt	CA
Schaumburg	CT
Dummerston	VT
Putnam	NY
Englevale	ND
Peterborough	OK
New Bern	MA
Garden Valley	TX
Speedway	IN
Cornwall	VT
Holly Springs	TX
Albia	NY
Oakland	VT
Good Hope	AL
Hyak	WA
Meadow Lake	AK
Winchestr Bay	OR
Belkofski	AK
Jane	MO
Flying H	NM
Burlington	NV
Scotchtown Branch	NY
Lavonia	VA
Vlg O The Hls	TX
Piggott	PA
Mt Arlington	NJ
Faulkner Springs	TN
Brownstown Twp	MI
Arbutus	MD
Woodhaven	OR
Appleton	SC
Biscay	MN
Morgan	NJ
Midlothian	WA
Fairfield	TN
Green Bank	NJ
Walworth	IL
East Peru	IA
Yorktown	NY
Adelphi	MD
Bear	AR
North Lauderdale	FL
St James	MN
Dorchester	NH
Washington Is	WI
Westminster W	VT
Talmadge	ME
S Salt Lake	UT
Lutherville Timonium	VA
Alpharetta	VA
Sprng Brk Twp	PA
Kingston	FL
Union	WI
Williams	PA
Peletier	NC
Genola	UT
Azalea Park	FL
Fenton	KY
March Arb	CA
Lake Ridge	VA
Alexandria	IA
Mingo Jct	OH
Franklintown	MD
Tobytown	MD
Maine	NC
Cedar Falls	MS
Woburn	NH
Emet	OK
Wren	OR
Willow Springs	WI
Ingleside	NC
Lower Swatara	PA
West Paterson	NJ
Saint Joseph	KS
Saint Mary	MT
Case	MO
Fort Dodge	MN
Dalton	NH
Cromberg	CA
Castle Valley	UT
Turlock	IN
Hamilton	NJ
Fairfld Glde	TN
East Garden City	NY
Russell	WI
Shamong	NJ
Hammondville	AL
Fair Oaks	CO
Garden City	NJ
Pomona	AZ
Sherman	NM
St. Anthony	ID
Heritage Lake	IN
Burke	VT
Truetown	OH
Esmond	SD
Liberty Townshp	OH
Naguabo	OK
Uppr St Clair	PA
Ybor City	FL
Jersey City	NY
Addison	IA
Osage Mills	AR
Mattoon	NM
Miami Lakes	FL
Valley Station	KY
Harpster	ID
Corcoran	MN
Mahaiula	HI
N Tonawanda	NY
Colerain Twp	OH
Fayette	ME
Hernando Beach	FL
Fairbanks	AR
Jeffersonvlle	OH
Bedford Heights	OH
North Fond Du Lac	WI
Broadview Hts	OH
London	MA
Dorrington	CA
Palmhurst	TX
Pittston	ME
Wave	AR
New Prue	OK
Callaway	FL
Prichard	ID
Violet	PA
Toronto	WY
Lake Barrington	IL
Cleora	OK
Chitina	WV
East Douglas	MA
South Duxbury	VT
Seattle	AZ
Clarendon	VT
Tinmouth	VT
Salt Lake City	CO
Rockleigh	NJ
Princeton Jct	NJ
Ellisville	MO
Johnsons Corners	OH
Cheektowaga	NY
Frogmore	SC
Willow Springs	CA
Dalton Gardens	ID
Mt Airy	NC
Anchor Bay	CA
Marble Cliff	OH
Wheaton	MT
Hill	TX
Climax	KS
Jefferson Cty	MO
Interlaken	MA
Mt Crested Butte	CO
Austin	IA
Remerton	GA
Eagle River	SD
Lower Salford	PA
Fountain	IL
Austintown	OH
Carlisle	OH
Mountain Brook	AL
North Johns	AL
Knollwood	IL
Sid Town	MI
Dickson Cty	PA
St. Albans	WV
Ellicott City	MI
Mammoth	WY
Terry	LA
Cold Springs	CA
Deptford	NJ
Volney	NY
Austin	NE
Jeffersonville	PA
McMurray	PA
South Hill	WA
Hampton	MO
London	FL
Algona	WA
Wilton Manors	FL
Lewistown	MD
White Rock	MO
Mineola	AL
St. Croix Falls	WI
Bloomington	OH
Henly	TX
Mount Airy	VA
Old Shawneetown	IL
Roseto	PA
Arcola	TX
Oak Grove	MN
Gulkana	AK
Red Wing	AR
Harmony	GA
Allison	IL
Kansas City	IL
Clearbrook Park	NJ
Camp Robinson	AR
Goodrich	KS
Gig Harbor	MA
Klipsan Beach	WA
Clark Station	KY
Washington	AZ
Webb Lake	WI
Coamo	MN
Trinity	FL
Otis	ME
East Missoula	MT
Deptford	NY
Mt Crawford	VA
Whitacre	VA
Hollywood	CA
Fort Collins	MN
Triumph	ID
Welby	CO
Mt. Carmel	UT
Interlachen	OR
Woodland Park	NJ
Minneapolis	WA
Mount Olive	NJ
Ballard	UT
W Lafayette	IN
Brooklyn	NJ
Millington	CT
Rockport	AR
Paradise	NV
Prince	NY
Aurora	CT
North Hudson	WI
Manassas Park	VA
Puritan	PA
Triplet	VA
Alliance	LA
Pittsburgh	OH
E Petersburg	PA
Rockville	CT
Osbornville	NJ
Joint Base Lewis McChord	WA
Cottage Lake	WA
Point Pleasant	OH
St Augustine	IL
East Brunswick	ME
Sheboygan Fls	WI
East Norriton	PA
Pomona	MD
Tierra Verde	FL
Fulton	WI
Brookside	WV
Breezy Point	MN
Auburn	TX
Shepherdsvlle	KY
Toronto	VA
Roanoke	MO
Lower Merion	PA
Pumpkin Center	CA
Lafayette	VA
Burrillville	RI
Orcutt	CA
Sugarloaf	FL
Philadelphia	NJ
Royal	TN
Jamaica	PA
Williamsburg	IL
Oak Beach	NY
West Bath	ME
Seville	MI
North Quincy	MA
Otsego	MN
Mint Hill	NC
Claiborne	MS
Lone Camp	TX
Fort Dix	NJ
Cabin Creek	AK
Little Egg Harbor Twp	NJ
Pace	FL
Naples	OH
Norwood Young America	MN
West Hills	NY
Davenport Center	NJ
Elk Run Heights	IA
Old Point Comfort	CA
St. John	WA
Glen Riddle	PA
Union City	NY
Brooklyn	VA
Shelter Cove	CA
Parkville	MO
Kirtland	OH
State Bridge	CO
Montreal	OH
W Portsmouth	OH
Creal	KY
Arlington Hts	IL
Landgrove	VT
Birmingham	PA
Stoneville	SD
Marriott Slaterville	UT
Lords Point	CT
Grosse Pointe Shores	MI
Saratoga Springs	CT
Fontenelle	WY
Eldridge	ND
Kings Mtn	NC
Cheyney University	PA
Richmond	WI
San Juan	NY
Applegate	OR
Cascade-Fairwood	WA
Smith Village	OK
Jacksonville	TN
Laurelton	NJ
Canton	IA
Saint Teresa	FL
North Warren	PA
Manalapan	NJ
Marysville	NE
St. Charles	MO
Starhill	LA
Laguna Hills	MA
Chambers	GA
Buffalo City	WI
Kitchener	VA
E Sandwich	MA
Troy	KY
Clark	AZ
Greenfield	MN
West Brookfield	CT
San Antonio	CT
Glendale	TX
Yalesville	CT
Carbondale	IN
Ajax	CO
Wiccopee	NY
Galena	IN
Amity	ME
Fort Hood	TX
Silver Lake	OH
Manzanita Lake	CA
Cridersville	OH
Rock Hill	MI
N Ferrisburgh	VT
Milldale	VA
Arlington Heights	OH
Stanley	KS
Mocksville	PA
Cisco	AR
Union	PA
N Merrick	NY
Palominas	AZ
West Lawn	PA
Rotterdam	NY
Stoneboro	SC
Arlington Heights	FL
Pensacola Beach	FL
View Park	CA
Cincinnati	CT
Huber Heights	OH
Farr West	UT
Bellefonte	DE
Kismet	NY
Hudson	CA
Carroll Park	PA
Pleasant Cors	OH
N Smithfield	RI
Columbus	CO
Martins Ferry	WV
Pleasant Ridge Plt	ME
Elizabeth City	NY
Beach Park	IL
Jay	VT
Jacob Lake	AZ
Oakbrook Ter	IL
Sheffield Vlg	OH
Jones Creek	TX
Pleasant Gap	PA
Hassayampa	AZ
Arden-Arcade	CA
St. Petersburg	VA
New Ellett	VA
Schroeppel	NY
Hermon	ME
Haverhill	FL
Cohasset	CA
Swan Lake	MT
Winnemucca	PA
Sun City Ctr	FL
Govans	MD
Belle Isle	FL
East Brunswick	CT
Long Beach	MN
Salmon	TX
Calgary	NY
Midfield	AL
Santa Clara	NY
Hono	HI
Middleway	WV
Mettawa	IL
Eastbrook	ME
Wheatfield	NY
Peachtree Cty	GA
Madera Canyon	AZ
Washington Township	PA
Troy	IA
Shenandoah	TX
Cedarville	KY
Roxbury Township	NJ
Saint George	MN
Woodway	WA
Salisbury Mls	NY
St. Bonaventure	NY
Smiths Grove	CA
West Windsor	NJ
Dixmoor	IL
Corona Dl Mar	CA
Bellevue Town	WI
Chino Hills	FL
Scottsville	KS
Blasdell	NY
Oak Park Heights	MN
Hemp Ridge	KY
Alamo	NM
North Bingham	PA
E Saint Louis	IL
Shelby Township	MI
Sheffield Village	OH
Morristown	IA
St Landry	LA
South Ft. Mitchell	KY
Milwaukee	MT
Royalton	OH
Merriam	TX
Maverick	AZ
Corpus Christi	FL
Shorewood	MN
Roganville	TX
Gosnold	MA
Bowers	IN
Miles City	FL
Toledo	CT
Larue	PA
Broderick	CA
George Mason	NY
Newportville	PA
Ridgeside	TN
Otter Creek	IA
Agricola	MS
Alburgh	VT
Carney	MD
St. Joseph	MO
Minnetrista	MN
Sloan	SC
Montreal	CA
Brookfld Ctr	CT
Portage Lake	ME
North Syracuse	NY
North Prince George	VA
Roselle	GA
Los Angeles	TN
Bains	LA
Weeki Wachee	FL
Carpenter	MS
Pittsburgh	TX
Roessleville	NY
Tusayan	AZ
Upr Marlboro	MD
Cusseta-Chattahoochee County	GA
St. Joe	OH
Cross Timber	TX
Wequetonsing	MI
Sprouses Corner	VA
Dallas	CO
Port Griffith	PA
Felixville	LA
Tomberlin	AR
Windsor Hills	CA
West Toluca Lake	CA
Rose Lake	ID
Birchwood Village	MN
Sautee	GA
Pleasant Valley	TX
Orleans	NY
Collegeville	CA
Montecito	CA
Saginaw	TX
Mounds View	MN
Riverdale	UT
Long Beach	IN
Georgetown	NC
Parkfield	CA
Lower Burrell	PA
Rockford	CT
Red Oak	AR
Ave Maria	FL
Henderson	SC
Fort Worth	KY
Omega	IL
West Redding	CT
Lebanon Church	VA
Belroi	VA
West Somerville	MA
Trenton	PA
Apalachee	GA
Cassville	NJ
Batavia	CA
Fort McCoy	WI
Montgomery	MS
Hiltonia	GA
Rancho Belago	CA
Moody Afb	GA
Gainesville	WI
Hewitt	PA
Orneville Twp	ME
Bayou Vista	TX
Wilberforce	GA
Wyomissing	PA
Greystone Park	NJ
Windsor	ND
Dorchester	MA
Jerusalem	NY
Falling Creek	NC
Twin Hills	AK
Lawrence	IN
Westport Pt	MA
West Logan	WV
Ft Riley	KS
Irondequoit	NY
Bathgate	NY
Wrightstown	PA
Cabin Point	VA
Pahokee	OH
Byrnes Mill	MO
Cullen	NY
Deer Park	IL
Bratenahl	OH
Douglas	IA
Davenport	IL
Little Marsh	PA
Murray	MD
North Hills	NY
Sandy Rvr Plt	ME
Williams Creek	IN
Quintana	TX
Vlg Of 4 Ssns	MO
New Canada	ME
Hardwick	NJ
West Franklin	ME
Pine Grove	NJ
Fieldsboro	NJ
Eastside	OR
Blooming Grv	TX
Wall	PA
Machpelah	NC
Austin	CT
Mason City	MN
Ryan Park	WY
Converse	MS
Tuscarora	NY
Vaughn	AR
Cato	KS
Driggs	AR
Lake Of The Forest	KS
Clarksville	NH
Cammal	PA
Lamoine	ME
Bayview Gardens	IL
Chickasaw	AL
Chickaloon	AK
Mount Washington	OH
Cottonwood	UT
Euharlee	GA
Charlton	NY
Washington	CO
New York	TX
Chiniak	AK
Pooleville	OK
Sandy Point	MD
Rascal Town	TN
Shavano Park	TX
Fernway	PA
West Hartford	AR
Pauline	NE
Sky Ranch	SD
Lanesville	IL
Cahaba Hts	AL
Ben Avon	PA
Prairie Village	KS
Chalfant	CA
Dutch Mills	AR
Fallsington	PA
San Antonio	AZ
Corpus Christi	NJ
Washington Township	OH
Salt Springs	FL
Hays	KY
Plano	MA
Jackson Hts	NY
North Redington Beach	FL
Lindenwold	NJ
Hampton	OK
Deerfield Beach	OR
Queets	WA
Central Cty	KY
Silverdale	MN
Galena	SD
Mocanaqua	PA
Buckingham Township	PA
Bluff Point	NY
Moneta	WY
Montgomeryvle	PA
Childs	PA
Preston	UT
Melrose Park	PA
White Hall	AL
Cheboygan	OH
Christie	WI
Eastern	NE
Whistler	AL
Birch Bay	WA
Oak Grove	CA
San Francisco	AZ
Winterpock	VA
Massena Center	NY
Woolwich	NJ
Palm Shores	FL
Philadelphia	MA
Hallam	PA
Velma	MS
Royal Palm Beach	FL
Edgewood Arsenal	MD
Cayey	FL
Madeira	OH
Quincy	WV
South Euclid	OH
Attica	PA
Beryl Junction	UT
West Haven	UT
N Little Rock	AR
Lloyd Harbor	NY
Gresham	KY
Cranston	MA
Eagle Rock	CA
Mt Pleasant	SC
Sutherlin	IL
Trimble	CO
Ferrelview	MO
Rancho Park	CA
Pleasant Valley	WV
Brownstown Township	MI
Millers Falls	MA
Stratton	VT
Cresaptown	MD
Port Charlotte	PA
Ennis	MS
Meppen	IL
Limestone	OK
Hamilton Sq	NJ
Chester	ME
Fairhaven	OH
Westchase	FL
Diamond Bluff	WI
Washington	MA
Columbia	CO
Cuchillo	NM
Snoqualmie Ps	WA
Indian Shores	FL
Pine Hills	FL
Batavia	OK
Bells	NC
Montgomry Ctr	VT
Coventryville	NY
Howell	MN
Saint Charles	NY
Detroit	CO
Winrock	AR
Gloucstr City	NJ
Mt Enterprise	TX
Edwardsville	PA
Crescent Park	KY
Muncie	OR
Potsdam	PA
Lugert	OK
Whipple	WV
Eden Prairie	WI
Melbourne Village	FL
Clark's Point	SC
Washington	WI
Battlefield	MO
Memphis	MS
Litchfield	SC
Cincinnati	NE
Central Islip	CA
Colorado Springs	MI
Alton	TX
Orlando	OH
Swan Point	MD
Effingham	NH
Chi Chll Tah	NM
Palo Alto	PA
Lake Williams	ND
Centennial	CO
Gibraltar	MI
Connor Twp	ME
Dale City	VA
Milmont Park	PA
Wshngtn Ct Hs	OH
Central	MI
Santa Susana	CA
Harbor	OR
Wichita	TX
Rock Point	OR
Skyline	KY
Pinellas Park	LA
Alexandria	DC
West Point	AL
Kensington	NH
Hazle Township	PA
Mount Holly	SC
E Grand Forks	MN
White Bear Lake	MN
Flat River	MO
Carrollton	WV
Thick	TN
Carbon Hill	IL
Wildwood	IL
Kimball	MI
Cumberlnd Cty	TN
Trenton	ME
Burnsville	KS
Lowell	WV
Westport	NH
Ragersville	OH
Iron Springs	PA
Dock Junction	GA
Oak Glen	CA
Williamson	AZ
Leicester	VT
Hallandale Beach	FL
Wanamassa	NJ
Toronto	FL
Frenchglen	NV
Marlowe	WV
Natrona Hts	PA
Crp Christi	TX
Green Twp	NJ
Osage	AR
Stronach	MI
Ava	AR
St. Paul	NE
Marshallton	DE
Connor	TX
Greenville	DE
Port Royal	TN
S Zanesville	OH
Corona	CT
Evergreen Pk	IL
Quebec	CO
Norton Shores	MI
South Milwaukee	MD
Rotterdam Jct	NY
S Lake Tahoe	CA
Ewing	NJ
Manitowsh Wtr	WI
Bolling Afb	DC
Upr Montclair	NJ
East Liverpool	WV
Bullfrog	UT
Calderwood	TN
Everman	TX
South Ogden	UT
Seabrook Island	SC
Gainesville	NC
Farragut	TN
Mexican Water	AZ
South Madison	OH
Shoal Creek	AL
Alabama	AL
Guaynabo	TX
Naval Academy	MD
Riverton	MN
Lee	OH
Beckton	KY
St Stephens	AL
Texas City	NE
Kirkville	MS
Ardsley	PA
Short	OK
Tamaha	OK
Ft Richardson	AK
Darnestown	MD
Sepulveda	CA
Waverly	MS
Norwood Park	IL
Wright-Patterson AFB	OH
Laurel Park	WV
Alvaton	GA
Lakeside	MO
Shrewsbury	MO
Graysontown	VA
McCains	TN
Woodstock	MI
S Ozone Park	NY
Broadview	CA
Burnt Woods	OR
Ferrellsburg	WV
Hilliard	WY
Brown County	OH
Evans	TX
Oregon	ID
Brick Chapel	IN
San Antonio	CO
Eastampton	NJ
Middlebrg Hts	OH
Greenbush	ME
Drew Plt	ME
Cane Ridge	TN
S El Monte	CA
Seabrook	GA
Smith Point	NY
Beaver Cove	ME
Ft Carson	CO
South Hempstead	NY
Olga	FL
Cave Spring	VA
Warren	MT
Flat Top Mountain	TN
Houstonville	NC
Chili	IN
Concord	NY
Culver	KS
Clinton Corners	WY
St. Peters	CA
West Bradford	PA
Middleburg Heights	OH
Newburgh Hts	OH
Fort Wayne	DC
Exeter	PA
Dilia	NM
Orange	VT
Sawtooth City	ID
Union	CT
Salt Sulphur Springs	WV
Prnc Frederck	MD
Mt Washington	KY
Kernersville	CT
Mayland	TN
Harpersville	NC
Tabb	VA
Marlow	WV
South Brunswick	NJ
Mt Holly Springs	PA
Zent	AR
East Fishkill	NY
Orion	MI
Denbigh	ND
Swissvale	CO
Philadelphia	DE
San Bernardino	MD
Dutch Neck Crossroads	DE
Horizon City	TX
Villa Madonna	NM
Laurel Run	PA
N Las Vegas	NV
Yosemite Village	CA
Beaver City	OK
Mt Washington	MA
Good Spring	PA
N Manchester	IN
University	VA
Friday Harbor	TX
Riverside	OH
The Hills	TX
Saint Florian	AL
West Charlton	NY
Royal Oaks	CA
Richmond	NH
Twin Oaks	MO
Log Cabin	TX
Union Grove	TX
Chestnut Hill	TN
Amicus	VA
Wilder	KY
Fort Chaffee	AR
Cambridge Junction	MI
Messiah College	PA
Landon	OH
Berry Hill	TN
Paoli	WI
Franklinton	MA
Salem Twp	ME
Folsom	NJ
Jefferson	NE
Copperton	UT
Lynnwood	NC
N College Hl	OH
Manchester	MO
Peterborough	FL
Sunrise	FL
Collegeville	IN
Vestavia	AL
Holiday Island	AR
Smith Island	NC
Optimus	AR
Kansas City	NE
Mount Airy	WV
Naranja	FL
Belden	NY
Park Row	TX
Wintersville	OH
Cheltenham	CA
Thermopolis	GA
Paxton	OH
Winchester	OK
N Muskegon	MI
Hickson	ND
North Charleston	CA
Peoria Hts	IL
Ivyland	PA
Duane	NY
Moro Plt	ME
St Clairsvle	OH
Parma	OH
Lyndhurst	OH
Osborn	ME
Deer Meadows	WA
N Kansas City	MO
Lansdowne	VA
Kildeer	IL
Ghent	OH
West Slope	OR
Liberty Township	OH
Cuyahoga Fls	OH
River Oaks	TX
Coldwater	TN
Plano	SD
Deadhorse	AK
New York	WA
Philadelphia	GA
Southern Shores	NC
Crafton	PA
Oaks	NC
Salsburg	LA
Blackton	AR
Wellington	FL
San Juan	AR
Colonial Manor	NJ
Centreville	DE
Bear Creek Springs	AR
Galipolis Fry	WV
Bandon	TX
Newburgh Heights	OH
Westmore	VT
Indian Creek Village	FL
Jackson Mill	WV
Bolivar Peninsula	TX
Grayson Springs	KY
Parnassus	PA
Dania Beach	FL
Bushnell	SD
Charleston	VT
Pembroke Twp	IL
Minnesota Lk	MN
University Cy	MO
Westlake Vlg	CA
Marmet	WV
Middle Spring	PA
Groveport	FL
Sidell	FL
West York	PA
Manhasset Hills	NY
Sargent	TX
Orocovis	NM
Galivants Fry	SC
Brainerd	IL
Winchester	WI
Wentworths Location	NH
Hallowell	KS
North Ft Myers	FL
Woodville	NC
Lacy Lakeview	TX
Selfridge	MI
Dexterville	WI
Gambier	MA
Chesterfield	NY
Enterprise	FL
Tustin	MD
Fire Island	NY
University of Virginia	VA
Winter Haven	NE
Tucson	CA
Woodland	ME
Silver Spring	OH
Fishkill	MI
Sunshine	CO
Wakefield	NH
Wht Settlemt	TX
Ottoman	VA
Crellin	MD
Pembroke	NY
Burgettstown	WV
Eddystone	PA
Copper Mountain	CO
Villa Hills	KY
Cardiff	CA
Webster	NH
Arden Hills	MN
Lakeland South	WA
Richland Ctr	WI
Pope	MA
Pagosa Springs	TX
Country Club	FL
Tappan	NJ
Greenfild Twp	PA
Hendersonvlle	TN
Helena	WY
Thornhill	VA
Zion	SC
Albuquerque	NE
Kingstown	NC
Dallas	OH
Toronto	CO
Harper	NC
Kirksville	IL
St. Paul	MN
West Palm Bch	FL
ERDA	UT
Mount Oliver	PA
Groesbeck	OH
Otisfield	ME
Lawing	AK
Cortlandt Mnr	NY
New Hyde Park	MD
Delhi	OH
Woodridge	MN
Acworth	NY
Barnes	WI
Lynnwood	GA
Pine Bluff	IN
Middleton	NH
E Liverpool	OH
St Peter	IL
Vancouver	CA
Symmes Twp	OH
West Pittston	PA
Tracy	OR
Lisbon	WI
Upr Sugarloaf	FL
Fort Washington	WA
Middlegrove	IL
Safe Harbor	PA
Rupert	PA
Christiana	DE
Claquato	WA
Camano City	WA
Mogollon	NM
Jacobsville	MI
Homewood	AL
Eagle Harbor	MD
Mansfield	NJ
Silver Lake	MI
Valrico	VT
Roll	OK
Texarkana	TN
Alexandria	NH
Davidson	NJ
Wahpeton	SD
Volo	IL
Madera	ID
Akron	MN
Capleville	TN
Rapid City	GA
Chicago	MO
Lakesite	TN
Encino	CT
St Petersburg	PA
Florence Junction	AZ
Flemington	NY
Langley	IN
Spring Creek	NC
Santa Rsa Bch	FL
Corley	AR
Clermont	CT
Fernwood	OH
Natchitoches	GA
Daretown	NJ
Pelham	MA
Fairview	NM
North Edwards	CA
Geneva Junction	WA
Winchendon	NH
Niagara Falls	IL
Mustang Ridge	TX
Wildwood	OK
Ludlow	IA
Wollaston	MA
Chubbuck	ID
Mc Connell	SC
Ohio	OH
Greenfield	WI
Cambria Heights	MD
Lennox	MO
Pass Christin	MS
Saint Lucie West	FL
Howell	TN
Harrisonville	KY
Creagerstown	MD
Lakeland	TN
New Carrollton	MD
Punta	NM
Fair Hill	MD
East St. Louis	IL
Fredericktown	KY
Los Altos Hills	CA
Rock Creek	NC
Marshfield	GA
Ballsville	VA
College Hill	MS
Milltown	SD
Santa Cruz	MI
Austin	RI
Kitchener	PA
Shirley Ctr	MA
W Hempstead	NY
Hazel Dell	IL
Hopelawn	NJ
Mt Morris	PA
Clarksville	KY
Duckabush	WA
Greers Ferry	AR
Oak Brook	MD
Zinc	AR
Sandy Hook	NJ
Yardley	PA
East Peoria	OR
Canal Lewisville	OH
Hartford	ME
Tolland	MA
Ft. Smith	AR
Nikolaevsk	AK
Brooklyn	IL
Rochester Hills	MI
Aquinnah	MA
Bonita	AZ
Richland	WI
Bridgeport	IN
Port Angeles	NM
St. John	KS
Branson West	MO
Bainbridge Island	NE
Lorado	AR
Galveston	FL
Newport Beach	TX
Ridgefield Pk	NJ
Rochdale Village	NY
North Randall	OH
Cloverdale	IL
Wshngtn Xing	PA
Salem	ME
Sandy Valley	NV
Epping	ME
Peachtree Corners	GA
Franklin	CT
St. George	UT
Shallow Water	KS
Alta	UT
West Caldwell	NJ
Cottage Grove	CT
Bowling Green	NY
Queen Creek	CA
New York	SC
Mitchell	IA
Palmetto	TN
Homewood	PA
Poughkeepsie	CA
Pittsburgh	MD
Ellisville	WI
Red Oaks Mill	NY
Bellmead	TX
Leeville	LA
Columbia	NH
East Dublin	GA
Minneapolis	MD
La Grange Highlands	IL
Goodsprings	NV
Columbia Sta	OH
Clear Spring	AR
Escondido	MO
Ellsworth	NH
Rapid City	WI
Saddlebrooke	AZ
Wanship	UT
Palm Beach Shores	FL
Burlington	NY
Williams Township	PA
Park Place	OR
Crawfordsvlle	IN
Etna	PA
Muddy Gap	WY
Stonewall Manor	VA
Kinloch	MO
Day	NY
East Atlantic Beach	NY
Vesper	KS
St. Robert	MO
Julien	KY
Batesville	OR
Marquam	OR
Guilford	VA
Red Shirt	SD
Horseshoe Bay	TX
Murray Hill	NJ
Winston	VA
Canadian Lakes	MI
Montgomery	OH
Guaynabo	CA
West Easton	PA
Camp Wood	AZ
San Bernardino	NV
Westover Afb	MA
Flint	MD
Little Red	AR
Racine	IL
Community	VA
Hillsborough	NH
Doebay	WA
Hoffman Est	IL
West Brandywine	PA
Dortches	NC
Green Fields	PA
Cty By The SE	TX
Point Breeze	NY
Palmview	TX
Yorkshire	VA
Swainton	NJ
San Joaquin Hills	CA
Eve Mills	TN
South Palm Beach	FL
Courtdale	PA
East Columbia	TX
Germantown Hills	IL
Dennistown	ME
Fort Pierce	TX
Plantation Key	FL
Mt Pleasant Mills	PA
Oregon	IA
Mineola	MO
The Crossings	FL
Philadelphia	TX
Hays	MD
Ausable Chasm	NY
Bingham	SC
Wright-Patterson Afb	AR
North Chesterfield	VA
South Prince George	VA
Municipality Of Monroeville	PA
Arnold	PA
Asharoken	NY
Brooklawn	NJ
Feather Sound	FL
S San Fran	CA
Woodside	CA
Seven Fields	PA
Franklin	MD
Abilene	DC
Bulltown	PA
Rocklin	NY
Clay	MO
Buxton Center	ME
Greendale	IN
Seven Points	TX
Crescent Beach	FL
Monona	WI
Central Valley	UT
Sinking Spring	PA
Washburn	IA
Hoback Junction	WY
Cedar Falls	MA
Chillum	MD
Tull	AR
Tampa Palms	FL
Maces Spring	VA
Lowell	NE
Erwin	MS
Post Creek	MT
Edna	IA
Flint	GA
Houma	NY
Calgary	OH
White Settlement	TX
Norway	MD
South Norfolk	VA
Big Prairie	MT
Saint George Island	FL
Vienna	FL
Saint Louis	OH
Fort Mc Clellan	AL
Monroe Township	PA
Downey	IA
San Angelo	KY
Eastvale	CA
Shelby	TX
Yarmouth	MA
Oklahoma City	CA
W Alexandria	OH
Springdale	OH
Jacksonville	CA
Kansas City	ME
Reno	TX
Forks Twp	PA
Burnt Chimney	VA
Villa Rica	IL
Tyngsboro	VA
W Lebanon	NH
W Hollywood	CA
Bibo	NM
Pittsburgh	AZ
Aberdeen	NY
Newport News	RI
Short Gap	WV
Sweden	ME
Rockdale	NY
Middleborough	MA
Irving	CT
Blackhawk	CA
Forest Hills	TN
North York	TN
Castle Shannon	PA
Hudson Oaks	TX
Hoover	AL
Cold Sprgs-Highland Hts	KY
Ridgefield	NY
Tazewell	GA
Hurst	KS
Indianapolis	MI
Brooklyn Park	MN
Grapevine	MD
Kiddville	KY
Washington	FL
Holly Lake Ranch	TX
Lely Resort	FL
Colonie	NY
Guadalupe	AZ
Fernandina	FL
Morgantown	MD
Rockville	SC
Square Butte	MT
Orono	NY
Waltreak	AR
Toll Gate	WV
Oberlin	PA
Galen	TN
Grays	SC
Miramar Beach	MD
Poplar	CA
Allerton	NJ
Big Rapids	AL
Seven Bays	WA
Lockington	OH
Chance	SD
Hoopersville	MD
Summerset	SD
S Williamson	KY
Egg Harbor	NJ
Druid	MD
Fredonia	AL
La Grulla	TX
Park	KY
West Allenhurst	NJ
Grover	UT
Mount Charleston	NV
Lake Louise	AK
Wintergreen	VA
Scotrun	NY
New Augusta	IN
Lakemoor	IL
Granite	OR
E Northport	NY
Vancouver	NV
Dome	AZ
Morgans Point	TX
Mt Sterling	IA
Saratoga	WI
Washington Township	NJ
Rosemont	PA
Edina	MN
Stone Mtn	GA
Watchung	NY
Nora	IN
Bennett	WI
Hunterstown	PA
Holiday Isle	AR
Rolling Hills	CA
Knollwood	TX
Newton Hlds	MA
Deatonville	VA
Munhall	PA
Stone Mills	NY
Dunlap	KS
Deephaven	MN
Jackson Ctr	PA
N Myrtle Beach	SC
S Charleston	OH
Maryland Hts	MO
Peters Corner	PA
Indianapolis	KS
Perintown	OH
Sun Lakes	CO
Kingsbury	CO
Sherwood Frst	MD
Pasadena	IA
Saline	GA
Lake View	AL
San Mateo	ID
Marshfield	IN
Temvik	ND
Standish	FL
Temecula	IN
W Henrietta	NY
Revel	AR
Bigpoint	MS
Richland	AR
Gloucester	IL
Parkdale	OR
Windsor Mills	OH
Macon	MI
Flatwoods	TN
St Johns	FL
Camden Wyoming	WY
E Wenatchee	WA
Raspeburg	MD
Surf City	NC
Palmetto Bay	FL
Tuolumne Meadows	CA
Lenape	PA
Amelia Ct Hse	VA
Keizer	NE
Tansboro	NJ
Hayden Lake	ID
Baldwin Hills	CA
Calhoun	MS
Camp Shelby	MS
Berlin	NV
Inverness	IL
Mound Landing	MS
Kingwood	TX
Woodbridge	IN
St. Mary's	PA
St Benedict	OR
Brighton Plt	ME
College Park	GA
Eckard	IL
Clermont	IN
Westlake	TX
Gladeview	FL
Rockdale	IL
Jefferson Pk	IL
Wesley Chapel	NC
Toledo	NY
Apple Valley	MD
Regina	VA
Watertown Town	MA
Hillsborough	CA
Blawnox	PA
Shreveport	TX
Good Pine	LA
Clovis	MD
Reno	MD
Huntington Bay	NY
Sweet Hall	VA
St Croix	IN
Beale	PA
Nashville	AL
Donansburg	KY
Woodland Washington County	ME
Mederville	IA
Brandon	IL
Olde Federal Pointe	GA
Linn	WI
Landa	ND
Saint Matthews	KY
Mt. Olive	AR
St. Edward	NE
Langdon	MO
College Hill	PA
Stouchsburg	PA
Bucksville	SC
Naplate	IL
West Lake Hls	TX
Goodnight	KY
Marshall	NY
Brentwood	MO
N Scituate	RI
Valley City	IL
Mt Holly	NC
Boxboro	MA
Cementon	NY
Reed Plt	ME
Wheatley Heights	NY
Highland Mls	NY
Raceland	KY
Princeton	MD
Biltmore Lake	NC
Shorewood-Tower Hills-Harbert	MI
Aberdeen	NJ
Fort Griffin	TX
Aquadale	NC
Reno	CO
New Canaan	SC
Mansfield	CT
Yreka	OR
Kansas City	AL
New Hope	NY
Vandalia	IA
Lower Gwynedd	PA
Oshawa	IL
Charleston	OR
Porter Ranch	CA
Tolono	AR
Caguas	CA
Wilson	TN
Claridon	OH
Washingtonville	CA
Carthage	MN
Aspen Grove	UT
Chicago	OH
South Cheektowaga	NY
Wittsburg	AR
Innsbrook	MO
Bay City	FL
San Antonio	MO
Lake Park	FL
Poinciana	FL
Edom	TX
Corpus Christi	OH
Cismont	VA
Wanamaker	IN
Massanutten	VA
Sewalls Point	FL
Davis Park	NY
Village Of Los Ranchos	NM
St. Marys	GA
Montz	LA
Elizabethtown	CO
Seven Lakes	NC
White Stone	GA
Simpson	PA
Mendham Twsp	NJ
Nelsonville	NY
Braintree	VT
Rocky Ripple	IN
Herndon	VT
Ocean Ridge	FL
Ormondsville	NC
Chestnut Hill Cove	MD
Windham	VT
Vancouver	OR
Alva	NC
Beekmantown	NY
Winslow	WA
Cairo	TN
Noxen	CO
Mammoth	UT
Dallas	CT
Montclair	VA
Barney	AR
Berkeley	WV
Whitsett	PA
Overall	VA
West Whiteland	PA
North Utica	IL
Springridge	LA
Scottville	LA
Weirton	OH
Old Rvr Wnfre	TX
Philadelphia	KY
Round Hill	NJ
St. Joseph	LA
Lake Forest Park	WA
N Riverside	IL
Riverdale Park	CA
E Wareham	MA
Willwood	WY
Castle Rock	IL
Waimanalo Beach	HI
Saddle Rock	NY
St. George	KS
Caddo Valley	AR
Amalga	UT
Childress	VA
Poydras	LA
McCoole	MD
Annapolis Jct	MD
Otsego	IL
Hartsville	PA
Convent Station	NJ
Cincinnati	AR
St. Lawrence	SD
Crystal River	NJ
Spaulding	OK
Broad Channel	NY
New Londn Twp	PA
Tarboro	MI
Overland Park	IL
Ormsby	PA
Lookingglass	OR
Philadelphia	CA
Kalaeloa	HI
Hanover Township	PA
Wamic	OR
St Regis	MT
Rcho Sta Marg	CA
Cherry Grove Beach	SC
Grandview	MN
N Weymouth	MA
Alamo Heights	TX
Johnsonville	AL
Raleigh	TN
Virginia State University	VA
Pleasant Pr	WI
Porter	MA
Johnsville	MN
Coffeyville	OK
Oakley	NE
Pleasant Gdn	NC
Mission Woods	KS
Big Spring	TN
South Whittier	CA
Wildwood	TN
Edinburg	OH
Quail Heights	FL
The Keyhole	FL
Seabrook	NJ
Kelly	GA
Goldentree	MD
Wilburton Number Two	PA
Ojo Encino	NM
East Irvington	NY
Plano	SC
Golden	WY
West Bend	PA
Pine Island Center	FL
Clam Falls	WI
Schererville	MA
Upland	PA
Bethlehem	WV
Crescent	NY
St. Germain	WI
Yeadon	PA
Chesapeake	WV
St George	SC
Indiana	IN
Village Of Garden City	NY
Maplewood	MO
East Brewton	AL
Sylvan Springs	AL
Deer Creek	IN
Ridgeport	IA
Morgantown	TX
Otter Lake	NY
Mountain Green	UT
York	NC
Southern Pnes	NC
Augusta	MA
Lyndon	NY
Norge	OK
Barrows	MN
Covington Township	PA
Ronok Rpd Afs	NC
Balboa Island	CA
Little Falls	OH
Canton	NE
South Westerlo	NY
Cedar Fort	UT
Thetford	MI
Tega Cay	MN
Weybridge	VT
North Charleroi	PA
N Franklin	CT
West Lake Hills	TX
Ctr Barnstead	NH
Orion	NC
Brownson	NE
North Muskegon	MI
Clare	NY
Alford	MA
Norfolk	FL
Tagus	ND
Alpha	NJ
Covington	WA
Potomac Falls	VA
Maxey	GA
Ualapue	HI
Chimney Point	NY
Raleigh Hills	OR
Pontoon Beach	IL
Woodcliff Lk	NJ
Pine Knoll Shores	NC
Brownlee	NE
Akhiok	AK
Stewartville	AL
Ukiah	KS
Ridgeway	CT
Brookings	CA
East Renton Highlands	WA
Oak Hill	VA
Millvale	PA
Deer Island	FL
Westfall	KS
Beddington	ME
Long Hill	CT
White Shield	ND
Mount Penn	PA
Rohwer	AR
Brighton	VT
Woolwich Township	NJ
Lanesborough	MA
New Britain	PA
West Hartfrd	CT
Long Lake	IL
Hudson	MT
Bethlehem Village	CT
Mills Junction	UT
Barefoot Bay	FL
Saint Davids	PA
Washingtons Birthplace	VA
Vernon	IA
Broken Arrow	MN
Dupont City	WV
West Point	UT
Sidney	ME
Highlands	MA
Kelvin	AZ
Greenstone	PA
Cape Meares	OR
Vevay	PA
Bakersfield	NY
Wilsonville	CT
Eagle	MN
Weston	NY
Marianna	OH
Ettrick	VA
Carroll Valley	PA
Gorman	CA
Cedar Hills	UT
Pks	NC
St. James	AR
Louisville	CT
Muscogee	GA
Matawan	NY
Knowles	WI
Bentleyville	OH
Ranshaw	PA
Delpro	AR
Perry	WI
Ysleta Del Sur Pueblo	TX
Mendota	MI
Lutherville	MD
West Granville	MA
Davidson	TN
China Grove	TX
Maud	KY
Fairway	KS
Piso	KY
Edmonton	AZ
Black Forest	CO
Tice	IL
Oklahoma	OK
Wallingford Center	CT
Pimmit	VA
The Hammocks	FL
Green Acres	FL
N Yarmouth	ME
Schoeneck	PA
Port Saint John	FL
Spokane Vly	WA
Montpelier	LA
Decatur	MA
Green Island	NY
South Lake Tahoe	NV
Flemington	TX
Villanow	GA
Erial	NJ
Blue Springs	MD
Sylvia Park	CA
Oconto	MS
Surrey	NY
Ft Walton Bch	FL
Rockerville	SD
Swoyersville	PA
Mountain Brk	AL
St Augustine Beach	FL
Orlando	MN
West Leechburg	PA
University Ht	OH
Navarro Mills	TX
Whittlesey	WI
Sennett	IA
Tempe	CO
University City	MO
Meiserville	PA
Asa	KY
Bethesda	IL
Sapinero	CO
Mercer	NJ
Hereford	VA
Cranberry Prairie	OH
Home	WA
Lemay	MO
Maple Glen	PA
Spring Brook Township	PA
Toronto	AL
Seneca	NY
Little Egg Harbor	NJ
Paradise	KY
Wilbur	IN
Knappton	WA
San Juan	NM
Lawrenceville	NJ
Ft McClellan	AL
Penacook	NH
Fitzhugh	AR
Santa Nella	CA
Bakersfield	AL
Bountiful	CA
Sierra Vista	IL
Jenkins Twp	PA
Ferguson	NY
Franklin Lakes	TX
Moose River	ME
Airmont	NY
Upper Saint Clair	PA
Baton Rouge	NY
Taylorsville	CO
Hampton	TX
Walnut Hills	OH
Russell Island	MI
Lava Hot Springs	CO
Salisbury	GA
Highland	VT
Thatcher	UT
Brookline Sta	MO
South Amherst	OH
St John Plt	ME
Sawyer	WA
Pueblo Pintado	NM
Sherwood Forest	CA
St. Joseph	IA
Bellerose Village	NY
Scottsdale	MD
Dallas	CA
Fort Myers	TX
Perkiomenvlle	PA
Gray	TN
Middle Vlg	NY
Shaw	MO
Woodland	MN
Underwood	TN
Pleasantville	IN
Wheeler Aaf	HI
Mantua	VA
Osterdock	IA
St. Ansgar	IA
San Antonio	NC
Big Otter	WV
New Baltimore	VA
Mason Twp	ME
Jolivue	VA
Williamston	AL
Chuathbaluk	AK
Topsail Beach	NC
Melville	MI
Pine	ID
Jacksonville	NH
Philadelphia	MD
Anaheim	WA
McCutchanville	IN
Gainesville	CA
Naples	IL
Red Bank	TX
Winsted	AL
Sassafras	MD
Trabuco	CA
Alabaster	IA
Oak Hill	TN
Sharon	NH
Clermont	NY
Morningside	MD
New York	MO
Sugar Creek	MO
Millcreek	UT
Kachemak	AK
Rockfish	NC
West Hazleton	PA
West Brentwood	NY
Forestburg	SD
Tensaw	AL
Roxbury	NJ
St. James City	FL
Stoneburg	TX
Herrold	IA
Paterson	NY
St. Petersburg	IN
Farmington Hills	TX
Redington Shores	FL
Mt. Meridian	VA
Modesto	TN
North Belle Vernon	PA
Port Conway	VA
Virginia Beach	PA
Wahneta	FL
Harding	PA
Madrid	ME
New Smyrna	FL
N Plainfield	NJ
North New Hyde Park	NY
Burdock	SD
Upper Chichester	PA
Youngstown	TN
Indialantic	OK
Montana City	MT
Wallace	NY
Foster City	CA
N Bethesda	MD
Grand Rapids	MA
Ft. Pierce	FL
Coulee	ND
North Grosvendale	CT
Lake Isabella	MI
Goodview	CO
Highland Hills	OH
Bay View	WI
Sanford	CA
Beaver Creek	WY
Fx Station	VA
Prunedale	CA
Lawrence Twp	NJ
Sea Breeze	NJ
E Dennis	MA
Rondo	AR
St Simons Is	GA
Enon	NC
Vinity Corner	AR
Highland Village	TX
Loudville	ME
Turkey Creek	IN
Hollister	ID
Berwyn Heights	MD
Dayton	MS
South Shore	OH
Porter	IN
Hobart	IA
Haley	SD
Windsor	FL
Monongah	WV
Wilmore	VA
Council	VA
Des Peres	MO
Fort Ritchie	MD
Hulmeville	PA
North Baldwin	NY
South Hampton	NH
Independence	MI
Edmunds Twp	ME
Sciotoville	OH
Duette	FL
Cyr Plt	ME
Mission Viejo	IA
Chippewa	MI
Rehoboth	DE
Cleona	PA
Hillandale	MD
Blackwood	PA
Laurel	AR
Clear Lake Shores	TX
Las Vegas	WI
Leona	KS
East Gull Lake	MN
Berryville	TX
Republican	NC
Benton Heights	MI
Forest Grove	IA
Rincon	CA
Erin Springs	OK
St. Paris	OH
Onaway	ID
Golden Shores	AZ
Dubuque	TN
Thornton	CO
Northmoor	MO
Wright	FL
Superior	NY
Kewa	NM
North Terre Haute	IN
St. Clairsville	OH
Richmond	HI
Rock Valley	MA
Buckhannon	MD
Long Neck	DE
Wyman	ME
Harding	MN
East Hills	NY
Sandyston	NJ
Ottawa	MN
Lexington	MD
Tioga	FL
Oxbow	ND
Diablo	WA
Postelle	AR
Chandler	NC
Ann Arbor	IL
Lancaster	IN
Binfield	TN
Swormville	NY
Queen City	OH
West Bend	CA
Lennox	CA
Surfside	SC
North Caldwell	NJ
St. Leonard	MD
Centerville	DE
Paradise	WA
Adrian	WI
South Salt Lake	UT
Wilberforce	MA
Saint Augustine Beach	FL
Cheek	TX
Lester	WA
Andalusia	PA
Harmony	NJ
Loch Lomond	CA
Mt. Vernon	IN
Volente	TX
Alta Loma	TX
Boone	NE
Wade	ME
Indian Hill	OH
Honey Grove	KY
Geetingsville	IN
Hayward	MI
Balmville	NY
Upper Providence Township	PA
Mt Sinai	NY
North Tustin	CA
Churchill	PA
Westworth Vlg	TX
Tamarack	ID
Grand Mesa	CO
Owensville	MD
Sand Draw	WY
Bronx	NJ
Tyrone	IA
Terra	UT
Cornville	ME
Lafayette	TX
Hanover Township	NJ
Moraine	OH
South Miami	MN
Edgecliff Village	TX
Big Creek	AK
Green Spring	KY
Fort Meade	MD
Shenango	PA
New Orleans	FL
Hanover Twp	PA
Arbaugh	OH
S Richmond Hill	NY
Denning	NY
Prairieville	AL
Flowing Wells	AZ
Peru	MA
Yosemite Valley	CA
Jamestown	IL
Engleside	VA
Dakota Dunes	SD
Foothill Farms	CA
Jasper	OR
London	AZ
Low Gap	KY
Stoutsburg	NJ
Chesapeake Cy	MD
Olympia Hgts	FL
West Aliquippa	PA
Swarthmore	NJ
Perry Hall Manor	MD
Exie	KY
Anchorage	MD
Domingo	NM
Grimsby	NC
North Miami	NY
Scotts Station	KY
W Jefferson	OH
Baker Heights	WV
Fort Worth	MD
Encinitas	AR
North Venice	FL
Nairn	LA
Barkhamsted	CT
Whitefish Bay	WI
Oyster Bay Cove	NY
Calgary	MA
West Park	FL
Brandywine	DE
Ingram	WI
Paradise Valley	PA
Balboa	CA
Lenoir City	NY
Highland Beach	FL
Leagueville	TX
Cove Fort	UT
Walker Lake	NC
Mill Creek	WA
Stamford	VT
North Saint Paul	MN
Prospect Hts	IL
Glenwillard	PA
Richwood	LA
Bellevue	TN
Eldersburg	MD
McCanna	ND
Harmony Grove	WV
Columbus	MN
Kensington	NY
Wentzville	IL
Robinson Springs	AL
Rockaway Bch	NY
Bristol	MD
Uppr Moreland	PA
Hopewell	AR
Ardmore	SD
Duck Key	FL
Marysville	WI
W Homestead	PA
Makaha	HI
Grafton	VA
Winslow	ME
Brighton	UT
Mesic	NC
Lima	OK
Verona	ME
Del Sur	CA
Loon Lake	NY
Captree Island	NY
North Rupert	VT
Radnor	PA
Vancouver	AL
Miami Shores	FL
Newberry	OH
Centerville	NJ
Haddon Hts	NJ
Ingomar	MS
Sundance	UT
Playa Vista	CA
Canoga Park	KS
Shoreline	WA
Afognak	AK
Jbsa Lackland	TX
Charlottesville	GA
Brenton	KY
Priest Lake	ID
Blair	NH
Vivian	WV
Kent Lakes	NY
Halesite	NY
Napton	MO
Conoy	PA
Klein	TX
Rutherfrd Clg	NC
St. Paul	AK
Bradys Bend	PA
Madison Heights	FL
Pittsburgh	WV
Greenville	TN
Colorado	OH
Browns	NE
New York	NJ
Nichols Hills	OK
Miami Gardens	FL
Yankee Hill	CA
St John	IN
Little Hickman	KY
Petersburg	CA
Trommald	MN
North Massapequa	NY
Airlie	NC
Providence	AR
Coxs Corner	MD
N Topsail Beach	NC
Custer Park	IL
Fredericktown	MD
N Fort Myers	FL
Connelly Springs	NC
Gloucester Pt	VA
Energy	MS
Brooks	WV
West Palm Beach	SC
Crystal Lake	MD
Los Ranchos	NM
Lake Clarke Shores	FL
Owl	CA
Brighton Heights	PA
Sylvania	MD
Minnetonka	AL
Derry	OH
Cloverland	WA
Tipler	WI
Glassboro	PA
Gulph Mills	PA
S Glastonbury	CT
Colebrook	PA
Triumph	LA
Goldsby	OK
North River	ND
Weldon	AR
Great Pond	ME
Choctaw Beach	FL
Marion Forks	OR
N White Plains	NY
Patterson Heights	PA
Stilson	GA
Queens	NY
Daniel Island	SC
Pierce	CA
Lockwood	NV
Urbana	NY
Indian Head Park	IL
Cross Creek	FL
Laguna Woods	CA
Tyro	NC
Storrs	CT
Laytonsville	MD
Weimar	NY
Tigard	OR
Brooks City Base	TX
Sunriver	OR
Wawina	MN
Cape San Blas	FL
Tennessee	TX
Fruitland Park	MS
Virginia Gardens	FL
Surfside Beach	SC
Woodbury	MN
Mt Pleasant	TX
Woodrow	AR
Garland	AR
Manson	CA
Sheboygan	MD
Albuquerque	AK
Wilmington	DC
Memphis	AL
Las Milpas	TX
East Holden	ME
Lakewood	TN
S Schodack	NY
Fort Wayne	TX
Stickney	IL
Stevensville	MO
Dinsmore	CA
Atlantic	OK
Toronto	MA
Oklahoma City	MO
Baden	MD
Providence	NH
Portsmouth	MI
York	CA
Sandtown	DE
Warrensvl Hts	OH
Smithtown	WV
Banner	IL
Hide-A-Way Lake	MS
Roswell	TX
Niagara	OR
Navarino	WI
Walker Lake	NV
Tigard	CA
Butler	SD
Palomar Park	CA
Ruth	CA
Satellite Beach	OH
White Lake	CT
St. Agatha	ME
Wakefield-Peacedale	RI
Cottrellville	MI
Shandon	NJ
Huntington Pk	CA
Antioch	WI
Gilman	MT
Bells Landing	PA
East Weymouth	MA
South Hill	NY
Piperton	TN
Landover Hills	MD
Honeyville	TN
Kragnes	MN
Susank	KS
Crescent Springs	KY
St Inigoes	MD
St. Johns	OH
Fearrington	NC
Mundelein	WI
Cedar Rapids	OH
Blackburn	OK
Bellefonte	AR
Stagecoach	NV
Jefferson Vly	NY
Evergreen	MT
Tucson	MI
Vestavia Hls	AL
Trio	SC
Dixon	SD
Atlanta	FL
Head Of The Harbor	NY
Ames	NM
Timberlake	OH
Steamboat	NV
Webster Groves	MO
Madrid Twp	ME
Jefferson Hills	PA
N Wildwood	NJ
Holbrook	NM
Goodings Grove	IL
Landover	MD
Pittsburgh	TN
Homestead Afb	FL
Haddon Township	NJ
Wecota	SD
Cincinnati	KY
Waverly City	OH
Doniphan	KS
Chatham Twp	NJ
Normandy Park	WA
Stevens Point	PA
Sweetwater	NE
Bertram	IA
Kingston	MD
Brunswick	NY
St. Henry	OH
Huron	KS
Saint Pauls	SC
Scotchtown	NY
Mooresville	KY
South Waverly	PA
Seattle	MD
St. Mary-Of-The-Woods	IN
Cincinnati	MA
Concordia	NJ
South Mtn	TX
Larchmont	VA
Skokomish Nation	WA
Ft Gordon	GA
Winthrop Center	ME
E Patchogue	NY
Columbine	CO
Turnersville	NJ
Saginaw Township South	MI
Eastover	NC
Lockport	NC
Mt. Hermon	LA
Eloise	FL
Toronto	WA
Aspen Hill	MD
Philadelphia	AZ
Callisburg	TX
Hainesville	IL
Denmark	KS
Smoketown	WV
Cypress	LA
Nassauville	FL
Adair	MO
Bernice	OK
Wellsburg	OH
Michigan City	VA
Atlanta	MD
Monticello	VA
Charleston	FL
Glenmont	MD
Fort Mitchell	KY
Ft Sumner	NM
Pope Army Airfield	NC
Anderson	OH
South Daytona	FL
Cropper	KY
Swansea	IL
Bellview	FL
Glen St. Mary	FL
Jacinto	AR
Montreal	IL
Mill Point	WV
Anchorage	CO
Elmira Hts	NY
Huntington Beach	NE
Manchester Township	NJ
St Elizabeth	MO
Livonia	AZ
Pacheco	CA
Hot Springs	AR
West Whately	MA
Davie	FL
Montreal	HI
Los Angeles	AL
Gary	KS
Edgewater	OH
Haskingsville	KY
Campton	IL
Winfield	IN
Middletown	KY
Triana	AL
Masonhall	TN
Pequannock	TX
Springfld Twp	MI
South Riding	VA
Lakeport	MI
Camp Beauregard	LA
Tarrant	AL
Maryville	MD
Woodlawn	MD
West Alton	NH
Roche Harbor	WA
Walnut Hill	FL
Albany	NH
Coalton	IL
Ft Wayne	IN
W Long Branch	NJ
Powdersville	SC
Parcel Return Service	DC
Rose Valley	PA
Fairview Heights	IN
Lackawanna Beach	WA
El Morro	NM
St George	VT
Tiptop	VA
Taylor	AL
West Ellicott	NY
Williamson	WI
Cuyuna	MN
Kemp Mill	MD
Bucktown	IN
Woodville	GA
Mobile	CT
Toronto	TN
Morea	PA
Mt Pleasant	TN
Prt Washingtn	WI
Yatesville	PA
S Sioux City	NE
Lanely	TX
Ivey	GA
West Hyattsville	MD
Chicago	AZ
Southwest Ranches	FL
Bronx	CT
Manchestr Ctr	VT
Crystal Lakes	MO
Perdido Beach	AL
Iowa Center	IA
Leadington	MO
Louisiana	LA
Byhalia	TN
Ulen	IN
Williamsville	DE
Svea	MN
St. Michaels	MD
South Farmingdale	NY
Osage	TX
Eden	IL
St. Matthews	SC
South Salem	CT
Jenkins	MO
Abbott	NM
Baker	OK
Uniontown	MD
Alexandria	MD
Shoreview	MN
Franklin	CA
Goulds	FL
St. Pete Beach	FL
Chesapeake	GA
Monroe	PA
East Corinth	ME
Pleasantview	ID
Mount Zion	IA
Primm	NV
Floris	OK
Goldfield	AZ
Forest Hill	TX
Independence	MN
Industrial Hillside	NJ
White City	FL
Northfield	NY
St Simons Island	GA
East Juliette	GA
South Floral Park	NY
Newbury	GA
N Billerica	MA
San Jose	WA
Huntingtn Wds	MI
Rutledge	PA
Charlottesville	TX
Penn Valley	PA
Willistown	PA
Bangor	FL
New Cassel	NY
Cortlandville	NY
Fallsburg	KY
Granville Center	MA
Kirksville	AL
Bucks Lake	CA
Cannon Creek	AR
Waterbury Heights	MD
Blades	DE
New Rome	OH
Johnston	IN
Madison Township	PA
Highland	CT
Martinville	AR
Vancouver	GA
Uniondale	NJ
Ragged Point	CA
Ft Washington	PA
Holly Ridge	LA
Baton Rouge	MD
Stibnite	ID
Shawhan	KY
Van Buren Bay	NY
Sparta	WA
Horseshoe Bnd	AR
Millstone Township	NJ
Oakland Gdns	NY
Citrus Spgs	FL
Luke Air Force Base	AZ
Carroll Plt	ME
Bellevue	CO
Ceylon	IN
Scarborough	NY
Lakeside	CO
International Falls	FL
Williston Pk	NY
Newburyport	IL
Scarborough	CA
St. Clair	MO
West View	PA
Asheville	TX
Indian Springs	AL
Dupont	PA
Saugus	CA
New York	DC
Lost Pines	TX
Bramble	MN
Argus	CA
Woodlawn Heights	IN
Millard	NE
Dhs	VA
New Kensington	VA
Giddensville	NC
Yes Bay	AK
Fredonia	TN
Yakima	MN
Wild Rice	ND
Linneus	ME
Shady Hills	FL
Garfield Plt	ME
W St Paul	MN
Feasterville	PA
Olympia	OR
Washingtn Twp	OH
Trujillo Alto	IL
West Gardiner	ME
Chemung	IL
Biddeford	OH
Carmel	NJ
Wabaunsee	KS
Artesia	IL
New Orleans	TX
Shaker Heights	OH
Hainesprt Twp	NJ
Jacksonville	CT
Blythe	AZ
Jefferson	WV
Spartanburg	MD
Spring	NJ
Panorama Village	TX
Toronto	MD
Cherry Grove	OH
Minnehaha Springs	WV
Bellevue	IL
Trucksville	PA
Garden City South	NY
Hastings	WI
Huntingdon Vy	PA
Little Falls	WV
Hebron	WI
Fairview	NY
Brookville	NY
San Antonio	NV
Plandome	NY
Lyman	NH
Goldfield	CO
Palos Verdes Estates	CA
Worsham	VA
Murray Isle	NY
Bend	NJ
Indianapolis	MD
Pruitt	AR
Bala Cynwyd	MD
Fort Salonga	NY
East York	PA
Patton Village	TX
Mannington	NJ
Yeehaw Junction	FL
Warren	CT
Shelby Twp	MI
Lamberton	PA
Hamilton Square	NJ
Palo	MN
Yadkin Valley	NC
Leal	ND
Bristol	NJ
Cold Spring	KY
West Peoria	IL
Ellport	PA
Quinby	SC
Charlottesville	AZ
Brandermill	VA
Dewitt	NY
Village Of Loch Lloyd	MO
Spokane	ID
Aloha	OR
Highland	UT
Oil Center	NM
Golovin	AK
Benton Harbor	IL
East Bethel	MN
New Fairfield	IN
Walnut Park	CA
Cuba	RI
Mayfield	OH
Mt Pleasant	MS
Richmond	FL
New Square	NY
Dalton	AR
Orono	MN
Island Hgts	NJ
Bradford	MA
Bayou Vista	LA
Steamboat	CO
Sauget	IL
Morgantown	MA
Wind Lake	WI
Wappingers Fl	NY
Baileytown	NY
Indian Point	ME
S Hempstead	NY
Raub	ND
Diamond	IL
Leo-Cedarville	IN
Fargo	MI
Wolf Creek	CO
Brookline	PA
Dallas	MD
Edgeworth	PA
Biscayne Park	FL
Langley	VA
Monroe	MA
Citrus Hts	CA
Buyck	MN
Blue Ash	OH
Yoe	PA
Verona Island	ME
Clifton	NY
Vigo Park	TX
Kossuth	MS
Rochester Hills	CA
Vedic City	IA
Woodcreek	TX
Shelby	WI
Idlewylde	MD
Moscow	VA
Palms	CA
Edgewood	CA
New Whiteland	IN
Fair Play	CA
Medicine Lake	MN
Scaggsville	MD
Abbott Park	IL
Glenburn	ME
Cocodrie	LA
Michigan Ctr	MI
Lake Ronkonkoma	NY
Cornelius	SC
Edwardsville	CT
Millstone Twp	NJ
Marvin	NC
San Lorenzo	NM
Seattle	NE
Burnettown	SC
Town Of Tonawanda	NY
Port St. John	FL
Ferrisburgh	VT
Cape Coral	WA
Alabama	TN
Woodland Beach	DE
Montrose	VA
Davenport	TX
Orenco	OR
South Superior	WY
Wilsonia	CA
Koliganek	AK
Bar Nunn	WY
Dutton	MI
Tega Cay	SC
Rennert	NC
Commerce Twp	MI
George Mason	VA
Gadsden	MD
Oreana	ID
South Mansfield	LA
Oakwood	CA
West Carrollton	OH
Mantua	PA
Shannon Hills	AR
Port Mayaca	FL
Fairport	NC
Riverton	WA
South Miami	FL
Sunderland	VT
Saginaw	MA
Granite Shls	TX
Detroit	KS
Appleton	ME
Saint Augusta	MN
Brighton	NY
San Carlos	WI
Busseron	IN
Flemington	MD
North Barrington	IL
Cullison	KS
Merrionette Park	IL
Stuart	AR
Nimmo	AR
Toledo	IN
Wailea	HI
Harlem Heights	FL
Pacific Plsds	CA
Westwood	KY
Atlanta	CT
Tusculum Coll	TN
Whitney	OR
Crossroads	VA
Southport	FL
Valley Falls	RI
Midas	NV
Falls Church	DC
Intl Falls	MN
Farris	OK
Vancouver	FL
Fourmile Hill	AR
Selma	AR
Durango	FL
Little Torch Key	FL
Monte Sereno	CA
Layton	FL
Tioga	NY
Mentor	MD
Summit	OK
Island City	OR
Harrisburg	TN
Conch Key	FL
Lake George	IL
Maplewood	MN
Clifton	LA
Clifford Township	PA
Burr Ridge	IL
Hampton Cove	AL
Mt Pleasant	NC
Pittston Twp	PA
King And Queen Court House	VA
San Miguel	OK
Clodine	TX
Southbridge	VA
Silver Spring	TN
Springs	NY
Rancho Dominguez	CA
Normandy	MO
Berkeley	NJ
Lake	IL
Beowawe	NV
Grosse Pointe Park	MI
Braintree	NJ
Swanville	ME
Ft Walton Beach	FL
Tomball	CT
West Rush	NY
Almont	OH
Vancouver	WI
Trenton	WI
Plumas Lake	CA
Shippensburg University	PA
Taconic Lake	NY
Crystal Springs	AR
Lake Hallie	WI
Four Forks	LA
Salesville	AR
Westworth Village	TX
Silver Hill	MD
Morton	WY
Warren	NY
Cincinnati	NJ
Thunderbolt	GA
Zeba	MI
Medomak	ME
Union Township	MI
Briarwood	NY
Grant Township	MI
Mangas	NM
Newburgh	ME
Groom Creek	AZ
Wind Cave	KY
Teaticket	MA
Diamond Lake	OR
Mountain Grv	MO
Hanover	NJ
Mowry	PA
Squirrel Hill	PA
Chelsea	SD
Princeville	NC
Avis	IL
Pinecrest	FL
Lake City	IL
Beaver Park	AZ
Dairyland	WI
Harrison Twp	MI
Cuprum	ID
South Vinemont	AL
Gold Creek	AK
Charleston	MA
Peoria	NY
La Habra Heights	CA
Nokesville	MD
Mason	OK
Southfield	CA
Kawaihae	HI
Rosewood	CA
West Freehold	NJ
Waynesburg	TN
Hawaiian Gdns	CA
Castle Pines	CO
N Sioux City	SD
Wemme	OR
Bull Valley	IL
Pembroke Pnes	FL
Kirkland	NY
N Lewisburg	OH
Bonanza	AR
Montezuma	CO
Fairplain	WV
Fontana	NC
White Lake	NC
Lochearn	MD
Saint Bernard	OH
Lake City	TX
Sycamore	IN
Scott Township	PA
Waltham	ME
Watauga	TX
Fort Wayne	WA
Danville	MS
South River	NY
Kendrick	OK
Ray Twp	MI
Star Mills	KY
Michigan Valley	KS
Chestnut Grove	KY
Northfield	NH
S Pasadena	CA
Milton	NJ
East Canton	OH
North Dinwiddie	VA
Acton	TX
Palmerton	HI
Clearwater	MA
Birds Lndg	CA
Kensington	CA
Lithonia	FL
Tilghman Island	MD
Union Beach	NJ
Honeyford	ND
St. Paul	KS
Cummington	FL
Bannockburn	IL
Nashua	CA
Sudley Springs	VA
Cascades	VA
Kirksville	KY
Linglestown	PA
Whitfield	KY
Southside Place	TX
Wheeling	MD
Mt Madonna	CA
Wabash	PA
Jackson	AZ
Defeated	TN
Centreville	PA
Flower Hill	NY
Higgins	OK
Waldo	ME
College	AK
Saginaw	NJ
Vancouver	DC
Ypsilanti	OH
Sabula	IL
Nevada City	MT
Hot Springs	WV
Greentree	PA
Havre	MD
Miromar Lakes	FL
Bethany	OR
Academy	SD
Trabuco Cyn	CA
Chicago	IN
Luquillo	MI
Amherst Center	MO
Hunt	ID
Green Oaks	IL
Aguadilla	DC
Chico	OK
Chicago	MD
Parksville	TN
Shively	KY
Rio Grande	CO
Mitchellville	MD
Columbia Fls	MT
Erie	OH
East Lansing	AL
Broadwell	KY
Manawa	IA
Christiansburg	NC
Bourne	MA
Carnation	PA
N Bellmore	NY
East Magic	ID
Burtchville	MI
League City	CT
Bartonville	TX
Matlacha	FL
Universal Cty	CA
Crooked River	OR
Santa Rosa Valley	CA
Big Springs	AZ
Croton	MI
Kappa	IL
Fort Bliss	TX
Spokane Valley	WA
Fort Polk South	LA
Miranda	SD
Mobile	TN
Crestwood	MO
Mentor-On-The-Lake	OH
Lisbon	AR
Newberg	ND
Taylor	NY
Oakland	PA
South Coffeyville	OK
Bethesda	VA
Fort Motte	SC
Hokes Bluff	AL
Grosse Pointe Farms	MI
Maidstone	VT
Ripley	ME
Southville	KY
Skull Valley	UT
Jean Lafitte	LA
Midland	LA
Pompano Beach	TX
Suggsville	AL
Falls City	FL
Lynn	MI
Mooresburg	PA
Dixie	AR
Rea	PA
Laurence Harbor	NJ
Detroit	MD
Mt Ulla	NC
Clear Lk Shrs	TX
Barnsboro	NJ
Salladasburg	PA
Oswego	IN
Wolverine	KY
Westlake	MD
Oran	NY
Buechel	KY
Port Clinton	MI
Saint Clairsville	WI
Minnetonka	CA
Philadelphia	OH
Beverly Hills	MI
Tuttle	KY
Ludlow	ME
Texas City	CA
South Abington Township	PA
Center	WA
Industry	ME
Burlington	FL
Echelon	NJ
Ives Estates	FL
Homeland	GA
Rimmy Jims	AZ
Lone Oak	GA
Bethany	PA
South Corning	NY
Waldo	AL
Machesney Pk	IL
Ocean	NJ
Sibley	ND
Miami	VA
Allentown	IL
Surfside Beach	TX
Scotia	NY
Arden Hills	IL
New Wilmngtn	PA
Modena	WI
Williston	MD
Los Angeles	AZ
Farmers Branch	TX
Westport	OR
Jackson	ID
Cpe St Claire	MD
Grand Lake	AR
Nanwalek	AK
Hanford	MN
Miner	MO
West Brattleboro	VT
Montezuma	VA
Harris	KS
Chicago	MN
Crosby	AR
Vista	NC
Isla Vista	CA
Union Ridge	NC
Nida	OK
Williamsburg Twp	ME
Philipstown	NY
Renfrow	OK
Dedham	ME
Lake Waukomis	MO
Silver City	PA
Fitchburg	WI
Saint Pete Beach	FL
N Falmouth	MA
Saint Huberts	NY
Whispering Pines	NC
Corpus Christi	NC
Sunset Hills	MO
Norfolk	GA
Bobtown	IL
Pleasant Lake	ND
Mangonia Park	FL
W Caldwell	NJ
Presidio	CA
Dooley	MT
Katalla	AK
Lk Hopatcong	NJ
Thompsons Stn	TN
Toronto	CT
Morrilton	CT
Fox River Valley Gardens	IL
South Hills	PA
Saint Louis	AZ
China	MI
Reminderville	OH
Carpenterville	OR
Calabasas Hills	CA
Caguas	FL
Panorama Vlg	TX
Cole	OK
Millwood	WA
Rubonia	FL
Wreford	KS
Little Mtn	SC
Amish	IA
Bedford	LA
South Harpswell	ME
Permanente	CA
Trace	KY
Adams County	OH
Norwood	IL
Yellowstone National Park	MT
Canaveral Air Station	FL
Bay Lake	FL
Hendersonvlle	NC
Beavercreek	OH
Manakin	VA
Sporting Hill	PA
McCullom Lake	IL
Upper Dublin	PA
Plaisance	LA
Cypress Gardens	FL
Bluffton	IA
Southaven	TN
Mt Lebanon	PA
Rowland Hgts	CA
Reed	OK
Lillydale	WV
Baltimore	CA
Lattingtown	NY
Scituate	RI
Decatur	WA
Jefferson Township	PA
Woodside	PA
Glendale	WI
Beckett Ridge	OH
W Burlington	IA
East Chicago	CT
East Bangor	PA
Turnertown	TX
Ann Arbor	AZ
Farmington Hills	MI
West Hills	PA
Colchester	NY
Cape Neddick	NH
Spaulding	IL
Lake Zurich	WI
Bromley	KY
St. Anne	IL
Princeton	FL
Ocean City	FL
Harrods Creek	VA
Crestview Hills	KY
Sandston	NJ
Indian Twp	ME
West Haven	VT
Garden City	VA
Misquamicut	RI
Henry	IN
Fairhaven	MN
Edisto Beach	SC
Seven Hills	OH
Brant Beach	NJ
Philadelphus	NC
Buffalo	FL
Cahokia	IL
Boston	MD
Acequia	ID
Rochester Hills	MD
Bingham Farms	MI
Glade Springs	WV
Canoncito	NM
W Sacramento	CA
Coos Bay	PA
Dardenne Prairie	CT
Brodbecks	PA
Broadwell	IL
St. Clair Shores	MI
Virginia	VA
Gates	NY
Saint Louis	WI
New Berlin	OH
Plains Township	PA
Juno Beach	FL
Aspinwall	PA
Melrose Park	CA
New York	NY
Humacao	MA
Damascus	TN
South Zanesville	OH
Annis	ID
Kitts Hummock	DE
Winston	NC
Mt Rainier	MD
Branson	CA
Austin	MI
Toa Alta	CA
Grand Mound	WA
Wyoming	WY
Rubidoux	CA
Romoland	CA
Kingston	MN
Nelson	NH
Peninsula	AK
Larksville	PA
Mt Hamilton	CA
C-Road	CA
Old Field	NY
Belville	NC
Forestville	MD
Batsto	NJ
Loyalsock	PA
Huntingtn Bch	CA
Oakville	GA
Bucksport	SC
White Rock	NM
Marine On St Croix	MN
Lowry	SD
Northgate	ND
Zion	NJ
Bloom	KS
Kennett Sq	PA
Heidelberg	PA
Yeager	OK
St. Joe	AR
New Hope	NC
Brooklyn Heights	NY
St. Louisville	OH
Nowthen	MN
Coosawhatchie	SC
Kinnelon	NJ
Grand Rapids	MO
Mahoning	PA
Mt Sterling	IL
Castleton	NY
Peachgrove	KY
West Melbourne	FL
Jolly	TX
Ship Bottom	NJ
Yonkers	NJ
Philadelphia	IL
Lubbock	MA
Geneseo	ND
Walum	ND
Guilford Twp	PA
Glendale Hts	IL
Burnstad	ND
Inver Grove	MN
Manheim	NY
Hall	OK
Inglewood	NE
Fendley	AR
Georgia	GA
Merrillsville	NY
Boston Heights	OH
Mount Sterling	AL
Taylor	UT
East Canton	PA
Chelsea	ME
Diamond	WA
Cleveland	MD
Crete	ND
Greensboro	WI
Coventryville	PA
E Windsor	NJ
Mendon	VT
Switzer	KY
Staten Island	AR
Old Salem	TN
Clarence	IL
Tampa	MO
Lewisetta	VA
Milan	TX
Lavaca	PA
Leaksville	NC
Beddington	WV
Jenison	CT
Croydon	NH
Winona	CA
Shelburne	NH
Melrose	OR
Hyattsville	TX
Little Canada	MN
Holland	VT
Olympia	LA
Golden Glades	FL
Roanoke	GA
Willow Park	TX
North St. Paul	MN
Kasaan	AK
Timbercreek Canyon	TX
Indian Harbour Beach	FL
Roslyn Harbor	NY
Siloam Springs	OK
Ingalls	OK
Farmington Hls	MI
Otterville	IL
West Ocean City	MD
Sn Bernrdno	CA
Rosebud	IL
Salinas	KS
Birkenfeld	OR
Blacksburg	MD
West Palm Beach	DC
Jefferson	NJ
Lake Bryan	TX
Homeville	VA
Prince William	VA
Bristol	MA
Tinker Afb	OK
Toronto	TX
Hammond	MN
Lyndon	KY
East Lansdowne	PA
Deseret	UT
St Charles	MN
Blaine	KS
Callaway	IN
Syracuse	MI
Starks	ME
Big Cove	AL
Mt Washington	MD
Mechanicsburg	IN
Greenmount	PA
Oyster Creek	TX
Grants Pass	WA
Durham	SC
Georgetown Tp	MI
Hanahan	SC
Dupree	AL
Fort Lauderdale	MD
Alamo	MI
New Reading	OH
Bussey	AR
Bay Harbor Islands	FL
Keasbey	ND
Breckenridge	ND
Morning Star	AR
Eagle Center	IA
Blackhawk	IN
East Arlington	MA
Somerset	VT
Bayside Hills	NY
Chicago	NY
Lakehills	TX
Columbus	NY
Moorestown-Lenola	NJ
Round Lake Heights	IL
Maryland	MD
Village Of Four Seasons	MO
West Seneca	NY
Spring Mills	VA
Irwindale	CA
Helton	NC
San Diego	NJ
Anderson Township	OH
Santa Ana Pueblo	NM
Mc Cook	IL
Potomac	MT
Florida	MA
Wales	TN
Highland Park	NY
University Hts	OH
Gordonsburg	TN
Missouri City	CT
Hillsboro	VA
W Frankfort	IL
Ogden	AL
Browndale	PA
Glen Burnie	MI
Francis	UT
Ft Belvoir	VA
St. Maries	ID
Grasmere	ID
Rainsboro	OH
St. Charles	IA
Santa Fe	MN
Midland	MO
Prestonville	KY
Chatham	NH
Hardin Springs	KY
St Meinrad	IN
Calumet	IL
Rock Run	PA
Harmon	OK
Redington Beach	FL
Berkeley Hts	NJ
Southern	MI
Portsmouth	NC
Clements	KS
Indianapolis	AL
Maryhill	WA
Colina	PA
Mason	NH
Longdale Furnace	VA
Howard	MI
Oak Grove	AL
Hillsboro Beach	FL
North Hills	PA
South Worthington	MA
Statesville	VA
Tunica Resorts	MS
Richmond	NY
Tradesville	SC
Grissom	NC
Marathon Shrs	FL
Benbrook	TX
Little Valley	CA
Saginaw	AR
Mount Rose	NV
Bostonia	CA
Owensboro	IN
Casper Mountain	WY
Rice	KS
W Coxsackie	NY
Oak Grove	VA
Central	LA
Orlando	NY
Murphysboro	AZ
Jacinto City	TX
Minneapolis	SC
El Lago	TX
Big Chimney	WV
Hensler	ND
Blakely	PA
Dune Acres	IN
Milwaukee	AZ
Madeira Beach	FL
Eheart	VA
Valley View	OH
Hartford	PA
Saint Louis	WA
Jamaica Beach	TX
Lido Beach	NY
Lazy Lake	FL
S Bound Brook	NJ
Smiths Bend	TX
Minnesota	MN
Philadelphia	AL
Darlington	NJ
Beavercreek Township	OH
Garden City	PA
Lake Winnebago	MO
Dewey	WI
Stanton	DE
Lords Valley	PA
Wall	NJ
Silverdale	OR
S Dartmouth	MA
North Codorus	PA
Calvert	NC
Tatamy Borough	PA
Syracuse	MA
Brandon	AR
Perkins Twp	ME
Grinnell	CO
Roaming Shores	OH
Amherst	ME
Lantana	FL
Pinedale	CA
Bal Harbour	FL
Stovertown	OH
Richmond Hill	MA
Calcutta	OH
Riverdale Park	MD
Lewiston	WI
West Meredith	NY
Northlake	IL
Franklin Sq	NY
Amherst Center	NJ
Linfield	PA
Hollywood	IL
Browns	IA
Mickles	AR
Glenwood Lndg	NY
Mount Hermon	MA
Brooks	OR
Cottonwood West	UT
Johnson Lake	NE
Crow	OR
White Hall	WV
Los Cordovas	NM
Essex Jct	VT
Gill	MA
Mt Vernon	OR
Upper Holland	PA
Mayfield	PA
Bridgeboro	GA
Jeffersonvlle	IN
Kempton	ND
Forest Heights	MD
Trident	MT
Elko New Market	MN
Eagan	MN
Ely	AZ
Kirksville	CO
East Lake-Orient Park	FL
St. Augustine	MD
Neponset	MA
Newcastle	WA
Timonium	MD
Denver	MA
Milwaukee	PA
Setauket	NY
Texon	TX
Fort McNair	DC
Tarkio	MT
Knolls	UT
Mountain Lake Park	MD
Fishers	HI
Westbrook Center	CT
Belvidere	VT
Kelso	ND
Thornhill	NY
Hapeville	GA
Maalaea	HI
Albany Township	ME
Brentwood	PA
Aibonito	CA
Prairie	MO
Sunbright	CA
Vinings	GA
Ira	OH
Lake Lincolndale	NY
Prospectville	PA
Georgetown	MO
Ringgold	OH
Taylorsville	UT
Oakland	OK
Shady Shores	TX
Upper Gwynedd	PA
Palm Gardens	NV
Bloomfield Township	MI
Richmond Hill	NC
Queens Vlg	NY
Teaselville	TX
Washington	MD
Aventura	FL
Writsvlle Bch	NC
Hamilton Square	PA
Champion	IN
New Concord	NY
Barefoot Beach	FL
Clayton	MO
Fredericksbrg	VA
East Windham	NY
North Augusta	GA
Garden Grove	AZ
Reading	OH
Madison Hts	VA
Savannah	TX
San Clemente	MD
Uintah	UT
Chester Township	PA
Mascot	PA
Aflex	KY
Albuquerque	AL
Shreveport	TN
Hrtwk Seminry	NY
Council Bluffs	TN
Riverwoods	IL
Jackson Ctr	OH
North Tunbridge	VT
Oklahoma City	MN
Rock Rapids	MN
West Salisbury	WI
Concord	TN
Naguabo	NJ
Holeb	ME
Rabbit Hash	KY
Greenwater	WA
Kendall	FL
Oakland Twp	MI
Joliette	ND
Cadwell	IL
Mountain City	VA
Pelham Manor	NY
Hopkinton	NY
Red Mesa	AZ
Columbus Grv	OH
Day Heights	OH
Hamar	ND
Chattahoochee Hills	GA
Rockaway Point	NY
Greensboro	NY
Castlewood	CO
Penn Hills	PA
Loch Hill	MD
Armstrong	PA
West Bountiful	UT
Tampa	CA
SUNY Oswego	NY
Mine La Motte	MO
Auburn Douglas	IA
Nectar	AL
Pence	WI
Central City	AR
Fleetwood	NY
El Portal	FL
Ellington	VA
Kistler	PA
Dfw Airport	TX
Bybee	KY
Oakdale	MN
San Bruno	CO
Penllyn	PA
Winterstown	PA
Chase	WI
Bloomington	MN
West Cape May	NJ
Tisbury	MA
Hancock	KY
Parma	OR
Toa Baja	MA
Teatersville	KY
Warrior Run	PA
Holladay	UT
Westport Is	ME
Long Creek	IL
Kansas City	OH
Bridgeboro	NJ
Fairview	WI
North City	IL
Mottville	MI
Biltmore Frst	NC
Sault S Marie	MI
Surry Hills	NY
Montreal	AZ
Hamburg	VA
Juarez	FL
Fishhook	AK
Fircrest	WA
East Los Angeles	CA
Plymouth	NJ
Medford	MO
Maple Lake	WV
University Of Tampa	FL
Ferdinand	VT
West Glens Falls	NY
Ilchester	MD
St. Stephen	SC
Ridge	TX
Goodview	MN
Pittsburgh	OK
S Burlington	VT
Osceola	MN
Marble	CO
Yakima	ID
Gary	IL
Walters	VA
Center Square	PA
Lisbon	CT
Golden Valley	MN
Grandview	OR
Berlin	CT
Pojoaque	NM
Melcher Dallas	IA
Machias	WA
Surf City	NJ
St Ignatius	MT
Town Line	NY
Bedford Corners	NY
Oak Grove	OR
Bee Cave	TX
Fort Smith	MT
Huff	ND
New Brighton	MN
Mount Healthy	OH
Indian Springs	GA
Silver Cliff	WI
Ogden	CA
Shillington	PA
Apgar	MT
Starlight	IN
Dakota Ridge	CO
North Sullivan	ME
Hilo	CA
Gorst	WA
Brittons Neck	SC
Morehead City	MD
Pleasant Vly	NY
Limerick	PA
Waco	TN
Temple Terrace	FL
Halfmoon	NY
Emmitsburg	HI
Nicholasville	IN
Toronto	WI
Medley	TX
Nanakuli	HI
Pringle	PA
Elgin	KS
St Helena Is	SC
Burke	TX
Port St. Joe	FL
Rosedale	KS
Pine Lawn	MO
Charleston	NY
Lakewood	CO
Brock	TX
Currie	NV
E Bridgewater	MA
Arlington	NY
Charlottesville	WV
Mariaville	ME
Ohkay Owingeh	NM
Tamarac	FL
Dale	OK
Snyderville	NY
Lawrenceville	AR
Wall Township	NJ
Houston	NY
Waterford	NJ
McCarran	NV
Sloan	NY
N Richland Hills	TX
Elmhurst Township	PA
Pleasant Point	ME
McGovern	PA
East Arcadia	NC
Gurnee	CT
Francisco	NC
Durbin	ND
Orland Hills	IL
Olivette	MO
Chuluota	FL
Yatesville	IL
Shoshone	TN
Anderson Is	WA
Coto Laurel	NY
Valrico	TX
Red Bay	FL
Iowa City	OR
San Juan	FL
Moon Twp	PA
Edinburg	NY
Ashby	VA
Prosper	ND
S Yarmouth	MA
Center Valley	AR
Swatara	PA
Battleview	ND
Varnado	LA
Fredon Township	NJ
Mt Sterling	OH
Jaconita	NM
Hollis	KS
Claremont	MA
Sandgate	VT
Coleridge	NC
Bowdens	NC
Toronto	CA
Hopewell	NY
New Windsor	FL
Vancouver	CO
Ottawa Hills	OH
Ft Towson	OK
Eldora	CO
Grand Pass	MO
Bernards	NJ
Harrisville	UT
Prt Washingtn	NY
Northdale	FL
Wekiva Springs	FL
Laurium	MI
Wenham	WA
North Enid	OK
Leigh	TX
Pleasant Valley	MO
Keysville	NY
Franklin Twp	NJ
Viera	FL
Lerty	VA
Sand Point	MI
Lake Pocotopaug	CA
Jordan	AR
Deerfield	NY
Coal Grove	OH
Colerain Township	OH
S Bloomingville	OH
Long Beach Township	NJ
Brooklyn Ctr	MN
English Creek	NJ
Georgetown	AR
Oasis	ID
Free Hill	TN
Northlake	TX
Saddlebrooke	MO
Eatonville	FL
Racine	PA
Manitowoc	IN
Medford	ME
Guilford	NC
St. Anthony	OH
Brackett	WI
Reading	MS
La Prairie	MN
Hi Nella	NJ
Hough	OK
Laureldale	PA
Alpine Meadows	CA
Beaver Dam	AZ
Westerville	CA
East Camden	AR
Trezevant	VA
Wayne	IA
North Richland Hills	NJ
Saint Charles	MD
Post Oak	TN
Wawa	PA
Dixville	NH
Highlands	WA
Primrose	IA
Harvey Cedars	NJ
Universal Cty	TX
Lockport	TX
N Middlesex	VT
Tahawus	NY
University	AL
Mount Pleasant	WI
Charlottesvle	VA
New York	MN
West Miami	FL
Diamond	WV
Creston	MT
Bessemer Bend	WY
Alexander	ME
Lucerne Vly	CA
Urbancrest	OH
Waltz	MI
Thornhurst	PA
Forest Hills	PA
Woodhaven	MI
Buford	ND
March Air Reserve Base	CA
Inman Mills	SC
West Brownsville	PA
Dixon Landing	NC
Sweetwater Station	WY
Port Gibson	LA
Santa Isabel	CA
Kutztown University	PA
Atlantis	FL
Baileys Crossroads	VA
Unger	WV
Makawao	CO
Oak Forest	PA
Michiana Shores	IN
River Heights	UT
Kaumalapau	HI
Westport Island	ME
Sudbury	VT
San Felipe Pb	NM
Vealmoor	TX
Bethel	IN
Mt Sterling	KY
Calgary	WA
Mount Lebanon	PA
Lakeside	IA
Spokane	NY
Keuterville	ID
Mayport	FL
Abanda	AL
Moiese	MT
Pinewood	MN
Lansdowne	MD
Hublersburg	PA
Orlando	CT
Centerville	KY
Kinsey	AL
Lincoln	VT
New York	CO
Santee	NE
Moapa Valley	NV
Spofford	TX
Jacona	NM
Menlo	KS
Learned	MS
Bovina	MS
Coney Island	NY
West University Place	TX
St Augustine	NY
St Joe	IN
Elmira Heights	NY
Arcadia	IL
Arrowsic	ME
Index	NC
Virginia Gdns	FL
Northfield	ME
Fox Point	WI
Harvey	MI
Riviera Beach	MD
Kimberlin Heights	TN
Jonestown	TX
Sheffield	OH
Steuben	OH
Pt Pleasant	WV
Colville	AR
Potomac	VA
Wormleysburg	PA
West Richwoods	AR
Highland Lks	NJ
Portland	CO
Missouri City	IL
Scranton	DC
Chicago	WI
St Thomas	TX
Furnace Creek	CA
Banner Hill	TN
Goshen	VT
River Ridge	LA
Fremont	MD
Hitschmann	KS
Bellevue	MD
Trinity	NY
N Palm Beach	FL
Brwnsboro Frm	KY
Weatherford	MT
Cliffside Pk	NJ
Woodleaf	CA
North Irwin	PA
Samuels	KY
Carthage	ME
N Cape May	NJ
Uhland	TX
San Jacinto	IN
Odgen	UT
Fairfield	LA
Parma Heights	OH
Holden Beach	NC
Ellerbe	SC
Industry	CA
Plum Lake	WI
Jennings	NJ
Meaux	LA
Old Harbor	MA
Sherman	WI
Deerfield Bch	FL
Whitesburg	TX
LAKE POINT	UT
Overland Park	KS
Regency	TX
Grassy Creek	KY
Pine Valley	WI
Dickensonville	VA
Stonewood	WV
Winslow	CO
Mankato	IA
Moorhead	NY
Providence	VA
Mt Pleasant	AR
Chester Sprgs	PA
Ottawa	FL
Florida City	FL
Kimberling Cy	MO
Lacey	AR
Philothea	OH
St Rose	LA
Fritz Creek	AK
Sunrise	TX
Bolivia	IL
Las Cruces	TX
Garden City	GA
Bendertown	PA
Alkabo	ND
Westervelt	IL
Moscow	IN
Zelienople	NH
Mount Washington	WA
Litchfield Pk	AZ
Oklahoma City	MI
Death Valley Junction	CA
Berkeley	MO
Tulalip	WA
Tallahassee	MD
Potter	NY
Bayview	TX
Oneida Castle	NY
Geneva-On-The-Lake	OH
Snowball	AR
Manalapan	FL
Clay	CA
Maple Grove	MN
Gosport	AL
Camas	OR
Charlottesville	KS
Wardsville	MO
Cowlington	OK
Lahainaluna	HI
West College Corner	OH
Grangerland	TX
Glendevey	CO
Hawthorn Wds	IL
Road Forks	NM
Buena Vista Beach	OH
Dupont Station	DE
Warwick	PA
Newtown Sq	PA
St Peter	MN
Richmond Hts	MO
Saint Paul	MO
Fremont	TX
Peckham	OK
Windsor	NH
Tullytown	PA
Shenandoah	LA
Claremont	VT
Carthagena	OH
Levesque	AR
Toronto	MI
Fort Polk	LA
Fryburg	OH
Florida	MO
St. Joseph	TN
Cornishville	KY
Raynham	NC
Sharpsburg	PA
Aiken	FL
Eddington	PA
North Shore	CA
West Quincy	MO
Lorman	LA
Lone Star	AR
Pembroke Park	FL
Mt Juliet	TN
South Pasadena	FL
Florida	FL
Galveston	IL
Cabin John	VA
Meeker	LA
Rush	PA
Mud Lake	ID
Sterling Park	VA
East Yaphank	NY
Weymouth	OH
West Windsor	VT
Rollingwood	CA
Loraine	ND
Clear Spring	WV
Wood Village	OR
Superior	IL
West Dundee	IL
Silverton	OH
Downingtown	TX
Bemidji	NJ
Sandrock	AL
Duluth	IA
Dayton	ME
Mason Neck	VA
Toronto	NC
London	CA
Frazer	PA
Dewey Beach	DE
Ogle	PA
Sugarloaf Shrs	FL
Santa Ana	NC
Orsino	FL
Buford	AR
Egremont	MA
Yonkers	CA
New Hampshire	NH
Saratoga Hls	CA
Midwest City	OK
Green Valley	CA
Nissequogue	NY
Ophiem	IL
Sullivan	NY
Breckenridge Hills	MO
Weissport	PA
Fire Island Pines	NY
Bosque	CA
Paris	MT
San Antonio	KS
Cleburne	MD
S Wilmington	IL
Napaskiak	AK
Southglenn	CO
Bear River	WY
Charleston	OH
Boston	PA
Forest City	FL
Perth	NY
Lantana	TX
Oakland Township	MI
Blue Mound	TX
E Williston	NY
Deemston	PA
Niagara Falls	TX
Eklutna	AK
Delaplain	KY
Mineral Ridge	CA
Kilbourn	IA
Spring Valley	AR
Weyanoke	VA
Bethel Heights	AR
Fincastle	TN
Brighton	AL
Bogue	NC
Casas Adobes	AZ
Clinchport	VA
Muskegon Heights	MI
Rinard Mills	OH
Hunnewell	KS
West Salisbury	VT
East Hampton	MD
Greenwood Vlg	CO
Wallstreet	CO
Mukilteo	FL
Benson	UT
Portland	WA
Calgary	LA
Hollyglen	CA
Westchester	CA
Aetna Springs	CA
Savoy	AR
East Ridge	TN
Patrick Air Force Base	FL
Gove City	KS
Sherwood	TX
Palm Valley	TX
Hasbrouck Hts	NJ
Hideout	UT
Clyde	MI
Wetherington	OH
Metolius	OR
Council Bluffs	MI
Relay	MD
Union	OH
Forestdale	AL
Benton	NH
Pearland	KS
Jay Peak	VT
Ashwaubenon	WI
Tuxedo	NY
Rising Sun	MT
Franklin Township	MI
Blythe	MD
Atlanta	AR
Hillcrest Heights	MD
Crescent Lake Junction	OR
Frame	WV
Birmingham	TN
Alpharetta	IL
Richville	OH
Somerville	ME
Irondale	WA
Plymouth Mtng	PA
Barryville	PA
Somerville	MT
Kingstowne	VA
Danner	OR
McPhersonville	SC
Mount Pleasant	WV
Rome	ME
Incline Vlg	NV
Mechanicsvlle	VA
St Anthony Village	MN
Oakton	OH
Westmoreland	OR
Mt. Pleasant	DE
Middle Inlet	WI
Bear Valley	CA
Hilltop Lakes	TX
Inglewood-Finn Hill	WA
Loxahatchee Groves	FL
Carson	PA
Seat Pleasant	MD
Beavercrk Twp	OH
Sault Ste. Marie	MI
Ocean Pines	MD
Fairfield	UT
Minot	NY
Arundel	ME
Mercer	ME
City Ranch	CA
Eastwood	NC
E Falmouth	MA
Ferguson	MO
Springfield	CA
Ogden	OK
Lauderdale Lakes	FL
Rch Cucamonga	CA
South Chesterfield	VA
Durian	AR
Rockaway Beach	NY
Logan	MT
Lookout Mountain	AL
Wyndmoor	PA
Mainville	PA
Tukwila	WA
Ellisville	TX
Mt Vernon	ME
South Boston	MA
Bonita Springs	CT
Ft Stewart	GA
Dummer	NH
Freeborn	MO
Biltmore Forest	NC
Loudonville	NY
Glenville	NY
Salt Lake City	MD
Johnstown	ND
Camden	DE
Nushagak	AK
Winterset	OH
Poland	OH
Gilead	ME
Orland Park	IA
Mt Vernon	NY
East Patchogue	NY
Walnut Grove	KY
Orange Park	IL
Sugar Hill	GA
Poole	NE
Hatfield	MN
Narragansett Pier	RI
Saint Johns	FL
Amelia	VA
Martinsville	MD
South Pass City	WY
Southland	TX
Montreal	NY
Weston	ME
Gallatin Gtwy	MT
Ham Lake	MN
California	CA
Carolina Shores	NC
Maysville	IA
Dix Hills	NY
Between	GA
Sun Lakes	AZ
Tecumseh	IL
Green Rock	IL
Allisonia	VA
Central	NM
Terrytown	LA
Wallagrass	ME
St Michaels	AZ
Edgewater Prk	NJ
East Palo Alto	CA
Wappinger	NY
Richland Hills	TX
Danbury	OH
Willowick	OH
West Denton	MD
Tom	OK
Corpus Christi	KY
Green Level	NC
Milwaukee	MD
Cutler Ridge	FL
Limestone Gap	OK
Coburg	OR
Inkerman	PA
Slc	UT
Beaver Creek	CO
Unity	NH
Cedar Grove	CA
Bryn Mawr-Skyway	WA
W Swanzey	NH
Wales	MI
Round Lake Park	IL
Raleigh	TX
Denison	IL
Ft Leonard Wd	MO
North Ferrisburgh	VT
Sawpit	CO
Rohrerstown	PA
Thompson Springs	UT
Remington	OH
New Breman	NY
Conemaugh	PA
Omaha	MD
San Mateo	NM
Manchester	NJ
New Ashford	MA
Coral Terrace	FL
Clearlake Oks	CA
Burgdorf	ID
Nashville	WI
Akron	NC
Tampa	AZ
Darlingtn Hts	VA
Schenectady	CT
Bangor	WA
Hopewell	IN
Harvieland	KY
Oakalla	TX
Omaha	MI
Newton Township	MI
Olympia Flds	IL
West Collingswood Heights	NJ
Brandon	CO
Shinrock	OH
Bradenton	NJ
Sugarcrk Twp	OH
London	NV
Island View	MN
Westminster West	VT
Bee	OK
Natick	NV
Texas	TX
Wetonka	SD
Harrisburg	TX
Raisinvl Twp	MI
Gladstone	MO
Port Wentworth	GA
Lowell Point	AK
Avon	CA
Mosby	VA
Los Angeles	TX
Village Of Wellington	FL
Robinwood	OR
Meadowbrook	AL
Cornlea	NE
Stafford Township	NJ
Rulo	KS
Fort Smith	TX
Merriam	KS
North Atlanta	GA
Oklahoma City	OR
Albuquerque	MN
Athens	VT
Clarkston	FL
Littleton	VT
Poipu	HI
Merrimac	VA
Fort Myers	ME
Clarksburg	MA
Trotwood	OH
Fineview	NY
Mission	KS
South Weymouth	MA
Beaverdam	CA
Plain City	UT
Bolivar	MI
Woodland Hills	UT
Decaturville	OH
Athens	AR
Delanco	NJ
Bradbury	CA
Glen Park	NY
Rocky Mount	MD
Brush	CT
Grand View-On-Hudson	NY
St. Louis Park	MN
Willow Branch	IN
Talladega Springs	AL
Brookline	MO
Alpine	OR
Vinton	NY
Philadelphia	FL
Mt Repose	OH
Beach City	TX
Cumberland	ME
Wylandville	PA
Trent Woods	NC
Deerwood	WI
Dracut	OH
Tarryall	CO
Frenchtown	MI
Carver	OR
Edina	IL
Uppr Chichstr	PA
Cape Girardeau	IL
Gatesville	MS
Fairfield Glade	TN
Bellechester	MN
Holland	NE
Cayuga	MS
Edenburg	PA
Live Oak	TX
Omaha	NM
Palm Springs	FL
Laurel Spgs	NJ
Kansas City	MD
Woodland	UT
Wilton	NY
Jupiter Island	FL
Osceola	NY
Redding	OH
Shoreline	OH
Sleepy Hollow	IL
Colonial Park	PA
St. Bernard	OH
Sleepy Hollow	CA
Mermet	IL
Champion	NY
Grand Canyon Village	AZ
Fountain Lake	AR
Rio Grande	TX
Texas Creek	CO
Freestone	CA
Wildwood Crst	NJ
Palm Beach Gardens	FL
Glen Haven	MI
Baltimore	IL
Wood Heights	MO
Heartland	TX
Kansas City	FL
Jeff	IN
Absecon	CA
Wesleyan College	NC
East Meadow	CA
Florence	OH
Prospect Park	NJ
Mt. Horeb	WI
Carroll	NH
East Case	MD
Amarillo	OK
Taycheedah	WI
North Middletown	NJ
West Los Angeles	CA
Clifton Township	PA
S Glens Falls	NY
Algood	TN
Havasu Lake	CA
Avard	OK
East Orwell	OH
Ira	MI
Upper St. Clair	CA
San Antonito	NM
Bettles	AK
Glastonbury	IL
White Center	WA
Saint Anthony	MN
Holdenville	WV
Clarks Green	PA
Ottawa	TX
Clermont Harbor	MS
West Wyoming	PA
Hereford	SD
Altoona	WA
Moorhead	ND
St. Jo	TX
Mountain Park	GA
Cherry Valley	CA
Chesilhurst	NJ
Gravel Ridge	AR
Celestine	CA
Lodi	IN
Medley	FL
German Flatts	NY
North Springfield	VA
St. Marys	KS
Lashley	OH
Gills Rock	WI
Tredyffrin	PA
Nicolville	MN
Winterville	MD
Teaneck	WI
S San Francisco	CA
Charlotte Park	FL
Alto	LA
N Dartmouth	MA
Hartford City	WV
Wyoming	OH
Ellington	MA
McKenzie Bridge	OR
University Pl	WA
Hays	NE
Frostburg	KY
Cinnaminson	NJ
Lancaster	MI
Minerva Park	OH
Dover	VT
Lauderdale By The Sea	FL
Mansfield	IN
Waits River	VT
Crowley Lake	CA
W Yarmouth	MA
Nibley	UT
Morgans Point Resort	TX
North Pekin	IL
Elida	OH
Dunnellon	OR
Anchorage	MA
Sugar Island	MI
Cedar Green	VA
Forkston Township	PA
Chapel Hill	WA
Bartonsville	VT
Paris	PA
Sherwood Forest	MD
Athol	SD
Sarasota	GA
Pittsgrove	NJ
Sandwich	NH
Crittenden	AK
Public Landing	MD
Jbsa Randolph	TX
Baldwin	KY
Miflin	AL
Skullbone	TN
Summitt	KY
Sand Lick	VA
Hobson	NV
Richland	FL
Flaherty	KY
Vancouver	OK
Millstone	CT
Wheaton	MD
Fruita	UT
Ryland Heights	KY
Shorewood Hills	AR
Toronto	IL
Black Mtn	NC
Searles Valley	CA
Apple Valley	MN
Laporte	FL
San Juan	LA
Parris Island	SC
Willowbrook	KS
Balcones Heights	TX
Vista	NY
Mount Auburn	IN
Oregon	MI
Rolling Hills	WY
Leisure Lake	MO
Collingdale	PA
Bainbridge Is	WA
Stow	ME
Throop	PA
Taylor Lndg	TX
Moon Township	PA
Minneiska	MN
St. James	NY
East Millstone	NJ
Democrat	NC
Balch Springs	TX
Compton	TN
Shelbyville	GA
West Deptford	NJ
Muhlenberg	PA
Collinsville	CA
Alameda	FL
Chico	WA
German	NY
Canutillo	NM
Storm Lake	OH
Saltaire	NY
Alorton	IL
Venice	UT
Garden City Park	NY
Lochbuie	CO
Maryville	NY
Lk Havasu Cty	AZ
Cricket	NC
Harvester	MO
Lumberton Twp	NJ
Waquoit	MA
Clearwater Beach	MD
Federal Heights	CO
Whitehall	NJ
New Orleans	MD
Walloomsac	NY
Washington Pk	IL
Urban Honolulu	HI
Fort A P Hill	VA
West New York	NY
Kirkland	PA
Centerton	IN
Moorestown	MI
Beaverton	IL
Greenwood	MI
Great Neck Plaza	NY
Happy Jack	LA
Ramsey	MN
West Wildwood	NJ
Oak Ridge	TX
North Mankato	MN
Reno	CA
Schererville	NY
Waycross	NC
Gardens Corner	SC
Mound House	NV
North Stonington	MA
Hackensack	VT
East Raymond	ME
Clifton	ME
Upper Saddle River	NJ
Lonerock	OR
Highlands Ranch	CO
Piedmont	VA
Louisville	MD
Robbinsdale	MN
Williams Twp	PA
Austin	NM
Petersburg	IA
Pleasant Hills	PA
Oakland Acres	IA
Richmond	GA
Snow Lake Shores	MS
Oklahoma City	TN
Leaburg	OR
Barnes Corners	NY
Johnson	UT
Pine Mountain Club	CA
Kirksville	OH
Fillmore	MI
Rehobeth	AL
Stansbury Park	UT
Virden	NM
College Station	FL
Mount Olive	MD
Richland	NE
Oak Point	TX
Pierce	KY
Pt Mugu Nawc	CA
Atlanta	CO
Princeton	NY
Smithville	NJ
Watson	IN
Calgary	NC
Fort Denaud	FL
Parkland	FL
Harding	SD
Pine Hill	NJ
Pagosa Springs	OH
Triune	TN
Greystone	CO
Iowa City	AZ
White Oak	PA
Rockingham	VT
Woolwich Twp	NJ
Gaviota	CA
Caswell	ME
Arlington	DC
Highland Heights	OH
Doral	FL
Springfield	NV
Crystal Spg	PA
Stony Creek	MI
Shadeland	IN
Pintura	UT
Farmer	SD
Jennings	WI
Carroll	MD
Chamita	NM
Shadyside	PA
St Helens	OR
New Orleans	CT
Lyme	CT
Ft Washington	MD
Cranesville	WV
Greece	NY
Todds Point	KY
Elmore	VT
Finley	WI
Accotink	VA
Elmwood	NC
Port Graham	AK
Caguas	NY
New Providence	NY
Huntington	CT
Sky Valley	GA
Coralville	MN
Long Island	NY
Countryside	IL
Blue Mountain	NY
South Barrington	IL
Wall Twp	NJ
Hopewell Jct	NY
Sylvia	TN
Montauk	RI
Crystal	MN
Centerville	ID
Ovilla	TX
Hueytown	AL
Tysons Corner	VA
Mercer	WV
Siesta Key	FL
Marion	MD
Oklahoma City	TX
South Lynchburg	SC
Baton Rouge	MN
Cherry Grove	SC
Voss	ND
Centreville	IL
Bel Air	CO
Thompson Falls	IA
Hamlin	ME
Antietam	MD
Grandview Heights	OH
Maywood	AZ
Highland Park	PA
Mattawa	TX
Claiborne	LA
Stallings	NC
Mercerville	NJ
Northfield	IL
Gulf Port	IL
Shore Acres	MA
Twitty	TX
Hannover	ND
Peck Slip	NY
Washington	OH
Clifton	DE
Brighton	WA
North Atlanta	CA
Jackson	ME
Wilkinsburg	PA
Cordova	MS
Mountain House	CA
Harlingen	NM
Ellisville	KY
Ramah	LA
Sabana Grande	NY
Varner	AR
Wellesley Hls	MA
Kirksville	MI
Boonesboro	MO
Jenkins Township	PA
Tripler Army Medical Center	HI
Roslyn Hts	NY
Amelia	RI
Chandler	AL
Lakeside	OH
Windyville	KY
Fort Gillem	GA
Berkshire	VT
Bartlett	TN
N Ft Myers	FL
Tuscaloosa	OH
Edgemere	MD
Ethete	WY
Eagle Harbor	MI
Buffalo	CA
Morley	TN
Tooele	MA
Dardenne	MO
Mount Gretna Heights	PA
Pearl River	DC
Alameda	NM
Sorum	SD
Woodsdale	OH
Payne City	GA
Coconut Creek	FL
Pembroke	NH
Olmos Park	TX
Boardman	WI
Big Springs	ID
Summit	IL
Santa Fe Spgs	CA
Portersville	IN
Castle Hill	ME
Galisteo	NM
Matlacha Isles	FL
S Pittsburg	TN
Superior	MN
Twn N Cntry	FL
North Key Largo	FL
Stella	WA
Dowling Park	FL
Gun Barrel City	TX
Las Vegas	OR
San Antonio	MD
Greensboro	TX
Fleming Neon	KY
Spanish Springs	NV
Intracoastal City	LA
Robyville	ME
Grill	PA
Voorhies	IA
Poland Spring	ME
Roanoke	CT
St Bernard	LA
Chimney Corner	VA
Orange	TN
Conway	KS
North Bellmore	NY
Birmingham	MD
Medaryville	WY
Weston	WI
Naples	UT
Oak Ridge North	TX
Greenleaf	OR
Yarrow Point	WA
Horton Bay	MI
Mayfield Heights	OH
Chesterfield	IN
Briny Breezes	FL
Briarcliff	NY
Philadelphia	CO
Austin	CA
W Milwaukee	WI
Lake Oswego	NE
Sedona	NJ
Lake Park	NC
Elsmere	DE
Lime Village	AK
Elberon	NJ
Lone Star	KS
Marwood	PA
Jackson	KS
Rivermines	MO
Mariemont	OH
Vestavia Hills	AL
Big Springs	AR
Claiborne	AL
South Reading	VT
Lake Almanor	CA
Bueyeros	NM
Ceres	IA
Margate	FL
San Leandro	MI
Carlsbad	NY
Richmond	LA
Dakota	ND
N Attleboro	MA
West Chester	CT
Lawton	NJ
Renston	NC
Daufuskie Island	GA
Bloom Center	OH
Foxborough	MA
Anderson	SD
Colorado Springs	WI
Cross Lake Twp	ME
Palmyra	IA
Blairsden	CA
Gilboa	OH
Brighton	CA
Braddock	VA
Wriston	WV
Orin	WY
Heathrow	FL
N Springfield	VT
Chesterfld	VA
West Woodstock	VT
Loring	AK
Sandy Bay Twp	ME
Tower Lakes	IL
Beluga	AK
Butte Meadows	CA
Bartonville	IL
North Cambridge	MA
Promise	TN
Vancouver	PA
Toronto	NJ
Affton	MO
Chinatown	NY
Woods Landing	WY
Riverview	WI
Sioux Falls	VA
Rio Communities	NM
Fair Harbor	NY
Phenix City	GA
South Bend	KY
W Lakeland	MN
St. Nazianz	WI
Andover	VT
Marquette Heights	IL
Mt Pleasant	OH
Little River Academy	TX
Clinton Twp	MI
N Brookfield	MA
St. Lawrence	NY
Antelope	KS
Forest Park	CT
Mt. Healthy	OH
Warrensville Heights	OH
Waterford Township	MI
North Brentwood	MD
North Ogden	UT
Omaha	IA
Egypt	OH
West Orange	TX
Fenton	OK
Bermuda Dunes	CA
Sycamore Cove	CA
Seaside Park	NY
South Jacksonville	IL
Clifton Park Center	NY
Bass River	MA
Shepherdstown	PA
Laguna Heights	TX
Mount Crested Butte	CO
Markleeville	NY
Fentress	VA
Vinita Park	MO
San Bernardino	LA
New Marlborough	MA
Dardanelle	IA
Boykin	SC
Morristown	VT
Sageeyah	OK
Bingham	MI
Bay Head	NJ
Jackson	NY
Fort Collins	CA
Denver	UT
North Kc	MO
Bone Cave	TN
Dotsero	CO
Katy	WA
Bellevue	WI
Hillsboro Bch	FL
New Baltimore	OH
Brier	WA
Rushmore	MO
Verona	TN
Trescott Twp	ME
Austin	MO
Redan	MN
Rockledge	PA
Ft Wright	KY
Keystone Hgts	FL
Meadowlakes	TX
Oppelo	AR
University of Virginia	MA
N Arlington	NJ
Lowell	IL
Haydenville	NH
Vineland	WI
Jackson Hole	WY
Cornwells Heights	PA
Murray	TN
Plains Twp	PA
Seven Devils	NC
Manhattan	NY
Montreal	WA
Glenn Springs	SC
Arundel Hills	MD
Scriba	NY
Belvidere Center	PA
Dorset	TX
Ellicott	MD
Lake Worth	TX
Halls Crossing	UT
Jerome	IL
St Benedict	PA
Walker	MI
Cumberland	IN
Iron Junction	MN
Buck Mountain	AZ
Crossroads	CO
Widefield	CO
Sagerton	TX
Toronto	PA
Bay De Noc	MI
Sugar Mountain	NC
Little Diomede	AK
Warren	CA
Springfield	MI
Kimball	TN
Ludden	ND
South Huntington	NY
Sylamore	AR
Mount Pisgah	KY
Lisle	PA
Chesuncook	ME
Cordes Lakes	AZ
Clintonville	NY
Saint Louis	CA
Albuquerque	MD
North Franklin	NY
Le Ray	NY
Athens	MS
Rose Hl Acres	TX
Clunette	IN
Wardner	ID
Lake Quivira	KS
Conway	SD
Silver Spring	MO
N Bloomfield	OH
Annville	VA
Murray	UT
Turlock	MS
North Abington Township	PA
Stratton Mountain	VT
West Springfield	VA
Adrian	NC
Medway	GA
East Whiteland	PA
Wake Village	TX
Willsboro Point	NY
Newton	CO
South Boston	MD
Browns	AL
Hvre De Grace	MD
Waite Hill	OH
Nelsonville	TX
Franklin Furn	PA
Tysons Corner	MD
Sands Point	NY
Bay Point	CA
Ruma	IL
Sn Luis Obisp	CA
Wallace	LA
East Point	GA
Dorchester Center	MA
Hudson	MN
Holden Center	MA
Dale	OR
University	FL
Vancouver	UT
South Harrison Township	NJ
Cordova	FL
Colmar Manor	MD
Frontenac	MO
Freeman	IA
Sully Station	VA
Mt Prospect	IL
David City	OK
Roque Bluffs	ME
Frankfort Square	IL
South New Lyme	OH
Lake Lotawana	MO
Whitmore Lake	FL
Rushton	MI
Adrian	ND
Royal Oak	FL
Coral Springs	FL
Mt Braddock	PA
Chesterville	MD
Carrizo	AZ
Lake Angelus	MI
Kettering	OH
Whites Chapel	AL
Old Mill Creek	IL
Arleta	CA
Baker	AR
Palm Bay	IA
Ryland Hght	KY
Dwight	ND
Purdy	WA
Pierson Station	IL
New Orleans	CA
Kosciusko	NC
Lake Ozark	SC
North Kansas City	MO
Cumberland Head	NY
Jeanerette	NC
Pleasant	UT
Edom	VA
Harpersfield	OH
Theba	AZ
Urie	WY
Saxman	AK
Indianapolis	WA
S Williamsport	PA
Van Meter	PA
North Riverside	IL
Wilbur By The Sea	FL
Hervey City	IL
Manhattan	TN
Carpendale	WV
Ft Lewis	WA
Two Creeks	WI
Atlantic City	WY
Edenton	AL
Spring Bluff	GA
Ysleta Sur	TX
Collingwood	TX
Silver Spring	NY
South Williamsport	PA
Lino Lakes	FL
Norman	CT
Falling Wtrs	WV
Needham Hgts	MA
St. Petersburg	NY
East Cambridge	MA
Vernonburg	GA
Asbury Park	CA
Kickapoo	IL
Montpelier	MD
Garden City S	NY
Scituate Center	MA
Clinton	UT
New Brunswick	PA
Fostoria	IL
Russell	OH
Blue Hills	CT
San Antonio	TN
Washakie	UT
Jordan Mines	VA
Longview	MS
Cambria	WA
Sunfish Lake	MN
Penbrook	PA
Mt Aetna	PA
East Sebago	ME
Melrose	TN
Deer Valley	UT
Clyde Hill	WA
Nutter Fort	WV
Alvin	WI
Lansing	IN
Smithville	NY
Self	AR
London	NY
Rankin	MI
Bluffdale	UT
N Huntingdon	PA
Long Bch Twp	NJ
Ft Myers	FL
Langleyville	IL
Victoria	CA
La Salle	NY
Mahukona	HI
Scherr	WV
N Massapequa	NY
Milltown	AR
Westmont	NJ
Blue Eye	AR
Davenport Landing	CA
Golf	FL
Empire City	OK
Guilford	MT
Lake Spivey	GA
Katy	FL
Roseville	MN
Highland Haven	TX
Peytona	KY
Griswold	CT
Vincennes	IL
Big River	CA
Glencoe	AL
Florissant	KY
San Francisco	NY
Three Way	TN
Pleasant Grv	UT
Howel	KY
Johnson Valley	CA
Newnata	AR
Rockford	NE
Dover Air Force Base	DE
Sawyers Bar	CA
Gibsonia	OH
Camp Verde	TX
Santa Clara	MO
Ridgecrest	LA
Fair Plain	MI
Essex Village	CT
Medina	MN
Plantation Island	FL
Bivalve	NJ
Grandview	IL
Silesia	MT
East Lansing	AZ
Lenexa	KS
Langhorne Manor	PA
Cottage City	MD
Vineyard	UT
Dubuque	LA
Veterans Admn	NY
Shell Beach	CA
New Haven	SD
Hamilton	MN
Highland Heights	KY
Oklahoma City	AZ
Briones	CA
Pearsonville	CA
Woodland Hls	CA
Toronto	HI
Cheviot	OH
Phoenix	SD
Berkeley	MN
Rock City	NY
Trappe	PA
Chesapeake	NY
Prairieview	IL
Arab	NE
N Canton	OH
Wyoming	DE
St Marys City	MD
Genesee	WI
Northglenn	CO
Sumter	TX
Stannard	VT
Butte City	ID
Vinton	TX
Vernon	CA
St George	AK
St. Clair	MI
Fort Worth	AZ
N Charleston	SC
Cape Carteret	NC
Mattydale	NY
Eva	OK
Lake City	AZ
Lower Bank	NJ
Smith Point	VA
Brandonville	WV
Chevy Chase	DC
Coventry	NY
East Quincy	CA
Brooklyn Center	MN
Denver	CA
Rosemont	IL
Berwyn	MO
Ste Marie	IL
Commerce	CA
Roeland Park	KS
Tomahawk	WV
Mc Conelsvile	NY
Greeley	MA
Pritchardville	SC
Hillside	NY
Powell	NE
Bayou Cane	LA
Tyndall Afb	FL
The Forks Plt	ME
Jacobus	PA
Park City	IL
Roaring Brook Twp	PA
Kill Devil Hl	NC
Silverton	WV
N Kingstown	RI
Hollis	AR
Nashville	TX
Yarmouth Station	MA
Henrico	VA
Ames	NY
E Setauket	NY
Wethersfield	IL
St. Onge	SD
Jett	KY
Reunion	FL
Canton	KY
Hill-N-Dale	MD
Seattle	CA
Gordon Heights	NY
Heidlersburg	PA
Nantucket	NY
Lexington Twp	ME
Hodgkins	IL
Central Valley	CA
Middlesex	VT
Druid Hills	GA
Fairfield	MA
Monarch Beach	CA
Cobleskill	MA
North Logan	UT
Lutz	NE
Pt Washington	FL
Branchburg	NJ
Goddard	KY
Woodmere	LA
Smoke Bend	LA
Round Bottom	AR
Pittsville	DE
Custer	OK
Oldtown	IL
Aberdeen	MA
Montrose	MS
Walden	TN
Fern Creek	KY
Roxbury	MA
N Royalton	OH
Liberty Farms	CA
Port Dickinson	NY
Mt Pleasant	PA
Evansdale	IL
Colwyn	PA
Dearborn Hts	MI
Centralia	IA
Vicksburg	NY
Gaithersburg	KY
University Park	TX
Howe Valley	KY
Fairless Hls	PA
Price	KY
Miccosukee	FL
Kezar Falls	ME
Matthews	OH
Allensville	OH
Stockdale	IN
Bennettsville	NC
Bellevue	LA
Keweenaw Bay	MI
Fairview Park	OH
Lower Grand Lagoon	FL
Dayton	IL
Chincoteague	VA
Waimalu	HI
Hounsfield	NY
Beaux Arts	WA
Clark Center	IL
Shover Springs	AR
Lake Hamilton	AR
St. Johnsbury	VT
Norma	ND
Stone Ridge	VA
South Yarmouth	NY
Fridley	MN
Ogden	MS
Windsor	MS
Wheeling	TN
Cloverdale	PA
Perris	CO
Greenfield Township	PA
West Berlin	VT
Crystal Beach	TX
Young America	IL
Naperville	MN
Laguna Vista	TX
Sun City	TX
Culp	PA
Jber	AK
Dunmore	PA
Northern	IL
South Heidelberg Twp	PA
Huntsville	NE
Moline Acres	MO
S Chelmsford	MA
Ruxton	MD
Fairport	MI
Jonesboro	TN
Avondale	LA
Corinth	TX
Minneapolis	TX
Madison	OR
Edmonton	IL
Tonawanda	CT
Grape Creek	TX
Atlantic Hlds	NJ
Cogan House	PA
Ramrod Key	FL
Muir Beach	CA
Floyd	NY
Mesa	TX
Union Park	FL
Hermantown	MN
Wilkes-Barre	IL
Des Moines	WA
Lk Nebagamon	WI
Bear Creek Township	PA
Windsor	MI
Linda	CA
Arcadia	TX
Citrus Hills	FL
Lockland	OH
Georgia	VT
East York	OH
Monroe Township	NJ
Greenlawn	CT
Ross	IA
Brookline	VT
Kentucky	KY
Forest View	IL
Garland	TN
Carlisle	CO
Parchment	MI
Lake Wylie	SC
Maysville	CO
Ridge Manor	FL
Loretta	WI
Dellville	PA
Sienna Plantation	TX
Clarence Ctr	NY
Canaanville	OH
University Park	FL
Lajitas	TX
New Orleans	AL
Midland	MS
Big Canoe	GA
Bryte	CA
Richfield	MN
Montreal	MI
Wales	ME
University Pk	IL
Cankton	LA
Laurel Park	NC
Oella	MD
Friendship	NC
Tampa	WI
Quil Ceda Village	WA
East Parsonsfield	ME
South Carthage	TN
Albuquerque	AZ
Cleveland	OR
Lake Sherwood	CA
Drake	MO
Kalkaska	NE
Palmyra	OH
New Franklin	OH
La Selva Beach	CA
San Juan	NC
Pingree Grove	IL
Syracuse	NJ
Lowden	WA
Lynwood	IL
Bay St. Louis	MS
Goshen	OR
Nashville	CT
Leawood	KS
Campton Hills	IL
Pottsville	KY
Escobas	TX
Patillas	MA
Webster Grvs	MO
Otsego	MA
Bell Canyon	CA
Black Butte Ranch	OR
Westmere	NY
W Brentwood	NY
Rydal	PA
Porterville	MI
St. Paul Park	MN
Egan	IL
New Providnce	NJ
Ink	MO
Ashley	PA
Dalton Gdns	ID
Littleville	AL
Branchville	AL
Albany Twp	ME
Shorewood	WI
Freemansburg	PA
Redland	FL
Rockland	RI
San Francisco	MO
Chenoa	KY
Brushy Creek	TX
Elm Grove	WV
Green River	VT
Montebello	NY
Loch Arbour	NJ
College Hill	KY
Franklin Lks	NJ
Aurora	TX
Holly	AL
New York	MD
Chiriaco Summit	CA
Wisacky	SC
Sylvan Lake	MI
South Bloomfield	OH
Washington Terrace	UT
Saltair	UT
Otis Angb	MA
Snell	VA
Bishopville	TN
San Francisco	TX
Colma	CA
Nibbe	MT
Snowville	VA
Coolidge Corner	MA
Callaghan	VA
Lakeline	OH
Ford City	CA
Pine Mountain	TX
South Vacherie	LA
West Valley	UT
Curran	IL
North Haven	NY
Fort Wright	KY
Howards Grove	WI
University of California Davis	CA
Last Chance	CO
New Berlin	TX
Houston	VA
Fruitland Pk	FL
Interlaken	NJ
Howard	MS
Drake	AZ
Columbus Jct	IA
Ctr Rutland	VT
Emmet	WI
Finderne	NJ
Old Jefferson	LA
Sn Jun Batsta	CA
Perkasie	NJ
Kirby	TX
Coldfoot	AK
White Oak	NV
Center Hill	AR
Woodlynne	NJ
North Falmouth	ME
Knights Ferry	CA
Rowland Hghts	CA
Newell	CA
Watrousville	MI
Briarcliff	TX
Fairview	TX
Moravia	TX
Allison Park	TX
St Francis	KS
Gupton	NC
Littleton	ME
Bricktown	NJ
New Boston	OH
Red Bank	TN
Lago Vista	TX
Nashua	MA
Wilmington	VA
Mobile	AZ
Ford Heights	IL
Ryegate	VT
Briar Creek	PA
Guaynabo	IL
Lawrence	NJ
Zuber	FL
Rockford Bay	ID
Vanport	PA
Knoxville	VA
Byram Twp	NJ
Penalosa	KS
Lake Tapps	WA
Belvedere	CA
South Chicago Heights	IL
Patillas	AZ
Riverwoods	IA
Pompton Plns	NJ
Perry	PA
Weatherby Lake	MO
West Richfield	OH
Genola	MN
Surry	NH
Sunrise Beach	TX
Newtown	OH
Beach	WA
Norwood	OH
Secane	PA
Monarch	WY
Pennsdale	PA
Wesley Chapel	CT
Gannett	ID
Port St. Lucie	FL
Mt. Kisco	NY
Carmel-By-The-Sea	CA
Houston	MD
Franconia	VA
Wind Point	WI
Ironspot	OH
Flamingo	FL
Sanford	GA
Harris Crossroads	NC
Zion Crossroads	VA
Spencer	LA
Tewksbury Township	NJ
Kronenwetter	WI
Saint Paul	NY
Castalin Spgs	TN
White Bear Lk	MN
West Springfield	NH
Tice	FL
N Carrollton	MS
La Crescent	WI
West Concord	MA
West Scarborough	ME
Yuma Proving Ground	AZ
Rockaway	OR
New York	AZ
Byrd	OH
Lake Sherwood	MO
Ohio	NY
Minnetonka Mills	MN
Saylesville	WI
Bruce Xing	MI
Orchard Lake	MI
Lake Barcroft	VA
Massapequa	NE
Millbrook	OH
Quartz Hill	CA
Campsprings	KY
South Setauket	NY
St John	ND
Landgraff	WV
Nelson	NV
Randolph Ctr	VT
Carvel Beach	MD
Stateburg	SC
Columbia Heights	MN
Seaside Hgts	NJ
Burning Springs	WV
Desert Hills	AZ
Pine Castle	FL
Mahtomedi	MN
Fountain Hill	PA
Albany	PA
E Greenwich	RI
North Castle	NY
Edgewood	KY
E Harwich	MA
E Bernstadt	KY
Parkerfield	KS
Simmons	AZ
Bassett	CA
E Greenbush	NY
Pleasant Springs	WI
Chicago Hts	IL
Boston	NC
Dolton	SD
Deer Park	OH
Overland	KS
Hauser	ID
Galatia	KS
La Jolla	PA
Gainesville	DC
Lake View Ter	CA
Greenwood	CT
Dockton	WA
Yankton	NE
London	CO
Trowbridge	CA
Old River Winfree	TX
St. Peter	OH
Mirada	CA
North Branch	NJ
River Hills	SC
Woodlawn	AR
West Saint Paul	MN
Marlboro	MA
Rich Fountain	MO
Salisbury Beach	MA
Waterford Wks	NJ
White Oak	OK
Valley Sta	KY
Randolph Afb	TX
Plum	PA
Atlantic Beach	SC
Centerville	MI
Hollowayville	IL
Beaverton	IA
Hoover	SD
Gainesville	AR
Treasure Island	CA
Coatopa	AL
Athens	KY
Vandercook Lake	MI
Concord Township	OH
Spokane	OH
Swinney Swtch	TX
Buxton	ME
West Lealman	FL
Cpe Girardeau	MO
Cleveland Hts	OH
Rock Island	IA
Berenda	CA
Lawndale	SC
Veseli	MN
New Lebanon	MO
North Bethesda	MD
Ingleside On The Bay	TX
Seboeis Plt	ME
Upton	ME
Harpers Ferry	MD
Elmwood	LA
Hawley	MA
Creve Coeur	MO
Scotts Corners	NY
Seaville	NJ
Neshannock	PA
North Plainfield	NJ
Midtown	TN
Washington Tr	UT
Saint Leon	IN
Eulonia	GA
Greensboro	CA
Glacier	WA
Atascocita	TX
Waterbury Ctr	VT
Howard City	NE
Wylie	CT
Roxbury	NH
Lake Shore	MN
Summit City	CA
Hickory	IN
North College Hill	OH
Amherst Center	MA
White Riv Jct	VT
Elwood	UT
Prairie Rose	ND
Kingston	NM
Buffalo	WI
Robinson	TX
Jacksonville	MD
Monroe Twp	NJ
Elgin	MO
Broadlands	VA
Warr Acres	OK
Bon Air	VA
Cove	TX
Bloomfld Twp	MI
Norton	OH
Sheridan	CO
Gilgo Beach	NY
Lonetree	CO
New Marion	IN
Charlotte	SC
Providence	MA
Acres Green	CO
North Merrick	NY
Warren Park	IN
Fern Glen	PA
Navassa	NC
Vancouver	NJ
Shaker Hts	OH
Emerald Hills	CA
Bruce Twp	MI
Holt	MN
Fort Wayne	GA
South Glenwood Landing	NY
Fort Pierce	WA
Heizer	KS
Calgary	CA
Mimosa	TN
New Haven	MD
Fishers	NJ
Jonesboro	OR
Stonersville	PA
Medford	CT
Forty Fort	PA
Wailua Homesteads	HI
Ward Hill	MA
Hamburg	OH
Kings Point	NY
Woodstown	MI
Palermo	NJ
Stratton Mtn	VT
Burgess Junction	WY
War Eagle	AR
Moscow	MS
Sulphur Springs	MO
Oakford	PA
Holdrege	MS
Tiffin	CA
Dixville Notch	NH
Bermuda Run	NC
Grand Rapids	NC
South Weber	UT
Terrell Hills	TX
Black Mountain	NM
Nevils	GA
Saco	GA
Maltby	WA
Glen Raven	NC
Saint Louis Park	MN
Clayton	IA
Millwood	KS
Linwood	PA
Iowa	IA
Mtn Home Afb	ID
Sherrills Frd	NC
Colesville	MD
Tahoe City	NV
English Center	PA
Basham	VA
Upper Augusta	PA
Fisher	OR
South Plainfield	VA
Howard	WI
Santa Rosa	CT
Limestone	KS
West Arlington	VT
Double Oak	TX
Shulerville	SC
Columbus	CA
Hypoluxo	FL
Mossy Spring	TN
Mt Pleasant	FL
Shelby	AR
Va Hospital	TX
Riceville	KY
Townsends Inlet	NJ
Hill Country Village	TX
Winchester	CT
Fresno	MD
Greenwood	SD
Delta	FL
Castleton	IN
North Penn	PA
Vancouver	CT
Robbinsville	NJ
Crystal	ME
Cross Roads	TX
Ginger Hill	PA
Lincoln Heights	CA
Chesterville	ME
Holly Springs	AR
North Redwood	MN
Tompkins	NY
Lake Orion	WA
Celebration	FL
Eastborough	KS
Selma	TX
Bluff View	TN
Pownal Center	ME
Westwood	KS
Kansas City	AZ
Cypress	NM
Beachton	GA
Springfield Corners	WI
Caswell	NC
New Orleans	TN
Scio	MI
Variadero	NM
Los Ranchos De Albuquerque	NM
Greenwood Lk	NY
Coleman	AR
Coconut Grove	FL
Gages Lake	IL
Shives	AR
Clark Fork	MT
E Stroudsburg	PA
Elk Ridge	UT
Lubbock	MD
Hamilton	CA
Strong City	OK
Cincinnati	AK
Appleby	AR
Palma Sola	FL
Omega	VA
Klamath Falls	CA
Spartanburg	FL
Gainesville	AZ
Harris Hill	NY
Badger	AK
Calgary	TN
Fort Detrick	MD
Daisy	AR
Montrose	OH
Westphalia	TX
Fort Myers	PA
Lawrence Township	NJ
Hayesville	OR
Sunset	UT
New Strawn	KS
Bay Harbor Is	FL
Halibut Cove	AK
Coleman	NC
Deer Park	MD
San Carlos	TX
Upland	WV
Hurstbourne	KY
Englewood	NY
Wilkinsonville	MA
Deep River	WA
Le Center	CA
Columbia	TX
Cayey	CT
Agate	NE
Floydada	IA
Mount Bethel	NJ
Lake Santeetlah	NC
Butte Valley	CA
S Plainfield	NJ
Vancouver	VA
Mt Pleasant	UT
Mt. Ida	AR
South Sanford	ME
Boulevard Park	WA
Monroe	NJ
Morley	NY
Hoxeyville	MI
Pittsfield	NJ
Lake Success	NY
Modoc	KS
Hobart	WI
Dunwoody	GA
Trail Creek	IN
Avoca	PA
Cannelton	PA
N Miami Beach	FL
Lexington Pk	MD
St. Marys	NY
Smartsville	CA
Walton Hills	OH
Victoria	TN
Oaklandon	IN
Weathersfield	VT
Lake Grove	OR
Belmont	ME
St. Francis	MN
Woodville	CT
Kirkland	IN
Boston	AZ
St. Petersburg	FL
Kenilworth	OH
Whitehall	OH
Farmington	TN
Gilmanton Iw	NH
Velvet Ridge	AR
Brandon	NC
Leyden	MA
Orlando	NC
Fruit Cove	FL
Spring Lake	IN
Winston	IA
Peeples Valley	AZ
South Walden	VT
Vicksburg	MA
Grand Prairie	LA
Port Allen	HI
Joplin	AR
Peoria Heights	IL
Edmonton	TN
Trophy Club	TX
Montgomry Vlg	MD
Shelton	MD
Bald Head Island	NC
St. Matthews	KY
Redland	AL
Crabtree	NC
E Brunswick	NJ
Patuxent	MD
Heil	ND
Lum	MI
Sandy Springs	GA
E Boston	MA
Borodino	NY
Sugar Notch	PA
Penndel	PA
Walnut Grove	GA
Hills Prairie	TX
Edgewater Park	NJ
Centerville	ME
Four Seasons	MO
Montreal	TX
San Leon	TX
Wentworth	WI
North Haledon	NJ
Lakewood Village	TX
Turtle River	MN
Mayfield Hts	OH
Blue Springs	AR
Bend	CA
Gilt Edge	TN
Montgomery	MA
Dubina	TX
Delhi	MN
Ontarioville	IL
Houston	GA
New Diana	TX
West Milwaukee	WI
Clemville	TX
Medora	KS
Archdale	NC
Fredon	NJ
Waterford	VT
Fort Morgan	AL
Belmont Hills	PA
North Woods Beach	WI
Wando	SC
Brownington	VT
New Preston	CT
El Vado	NM
Bradley Gardens	NJ
Reform	GA
Olive Branch	TN
Mount Zion	IL
The Village	OK
St James	MD
Solomon	AK
Healy	MN
Lincoln	WI
Elliston	KY
North Bay Village	FL
Bee Caves	TX
Catalina Foothills	AZ
Citrus Springs	FL
Pistol River	OR
Huntingtn Sta	NY
Rosslyn	VA
Langdon	NH
Martinez	GA
Marshfield	ME
Plainfield	NY
Minneapolis	NE
Lakewood	LA
Mt Hood	OR
Hollywood Park	TX
Hancock	MA
Alum Ridge	VA
Trujillo Alto	FL
Stansbury Pk	UT
Weedonville	VA
Encinal	NM
Sequim	LA
Parlin Pond Twp	ME
White Hills	AZ
Holiday Hills	IL
Minneapolis	IL
Bancroft	KY
Ballard	WA
Zoarville	OH
Beech Mountain	NC
S Richmond Hl	NY
Bullittsville	VA
Gearhart	OR
Chino Hills	TN
Ocqueoc	MI
Hereford	MD
New Shady Grove	AR
Rochester	OH
Ypsilanti	IL
Tarnov	NE
Mingus	AZ
Vly Cottage	NY
Concord Twp	OH
McAlmont	AR
Danburg	GA
St Robert	MT
Dellwood	MN
E Millinocket	ME
Anchorage	KY
Gold Hill	CO
Prices Fork	VA
Riverton	VA
Medford Lakes	NJ
Big Water	UT
West Tawakoni	TX
Morrisville	VA
Old Columbine	AZ
Heathridge	TX
St. Louis	MO
Port Washington	WA
Arlington	CT
Woodlawn	OH
Grove City	FL
Newtown	CA
Mineral Hills	MI
Duran	NM
Cutler Bay	FL
Lake Wales	TX
Cocoa Beach	GA
Lakeland	CO
Boyer	IA
Sagamore Hills	OH
Leary	WA
Sawmills	NC
Richmond	RI
South St. Paul	MN
Southampton	NJ
Cape Haze	FL
West Valley City	UT
Slocum	TX
Smiths Ferry	ID
Wthrby Lake	MO
Cadmus	MI
Newark	NV
Village Of Lakewood	IL
Thompson Place	WA
Pedee	OR
Kent	MI
Veazie	ME
West Menlo Park	CA
Chaska	TX
Byram	CT
Romansville	PA
Davis	MD
New Gloucestr	ME
Moscow	ME
Walnut Grove	AZ
Southern View	IL
Blue Ridge	AZ
University Heights	OH
Dixie	ID
Vernon	WI
Ft Worth	TX
Yancey Mills	VA
Foote	MS
Cumberland	TN
West Durham	NY
Northwoods	IL
Verdon	SD
Ruby	MI
Brownstown	MI
Cleveland	IL
Fitchburg	KY
Glenarden	MD
Bowerbank	ME
Segno	TX
Sarasota	OH
Fort Gordon	GA
Two Rivers	IL
Linwood	WV
Toronto	ND
Carol Stream	KY
Brambleton	VA
Coon Rapids	WI
Clarksville	ID
Wildwood Crest	NJ
Latham	NC
Commerce	MI
Plains	VA
Kentwood	MI
Ottawa	OR
Millbourne	PA
Fort Jackson	SC
Newark	NE
Michigan City	ND
St Francisvle	LA
Oklahoma City	IL
Raisin City	CA
St. Patrick	OH
Salt Lake City	GA
Plantersville	SC
West Nanticoke	PA
Indian Beach	NC
Crescent City	WI
Burnham	IL
Sanitaria Springs	NY
Ascutney	NH
Eynon	PA
Douglas	WA
Greenland Beach	MD
Doran	MN
Floris	VA
Huntersville	SC
North Druid Hills	TX
Brooklawn	CT
Atlanta	DE
Sherman	KY
Trujillo Alto	TX
Squantum	MA
Travelers Rst	SC
Lyman	ME
Park Hills	KY
Bakersfield	FL
Trinity	LA
West Linton	IN
Langley Park	MD
Wilmington Island	GA
Argyle Twp	ME
Riverside	WY
Salt Lake City	MA
Richmond Hts	OH
Stotlers Crossroads	WV
Cherry Hills Village	CO
Twin	AL
Pittman Center	TN
Wyandot	OH
Chesterfield	NJ
St. Paul	CO
Isabella	MI
Delmar	PA
Dixon	MN
Lowrys	SC
Halifax	MI
Bay	OH
Redridge	MI
Pantego	TX
Oakwood Hills	IL
Shawnee Msn	KS
Maywood	FL
Wolverine Lk	MI
Columbine Valley	CO
Sweetwater	IL
Strawberry	AZ
Perrowville	VA
Raytown	MO
Dallas	AZ
Sea Bright	NJ
Espyville	PA
Golden	CT
Silver Reef	UT
Lewiston	NC
